EmployeeID,NightShifts,MorningShifts,AfternoonShifts,WeekendShifts,HolidayShifts,WorkingTimeMean,WorkingTimeVariance
1,11,232,221,0,0,7.4094827586206895,0.2774854455888936
2,59,236,177,0,0,7.745762711864407,0.2584926072845268
3,2,242,240,0,0,6.983471074380165,0.2984808477075569
4,4,235,231,0,0,7.217021276595744,0.2561192944171685
5,121,245,124,0,0,8.044897959183674,0.3053529608564755
6,237,237,0,0,0,10.784810126582279,0.23739540871057693
7,0,232,232,0,0,6.978448275862069,0.30689281982385186
8,0,243,243,0,0,6.7366255144032925,0.23613236744550095
9,8,230,222,0,0,7.256521739130434,0.3138219100056992
10,4,234,230,0,0,7.128205128205129,0.2152525586001963
11,201,241,40,0,0,8.385892116182573,0.27130013831259325
12,1,241,240,0,0,7.074688796680498,0.2443983402489645
13,229,229,0,0,0,9.25764192139738,0.25350494139278007
14,235,235,0,0,0,9.434042553191489,0.28088743407893046
15,0,241,241,0,0,6.1120331950207465,0.24156293222683115
16,0,237,237,0,0,6.641350210970464,0.290316813273259
17,0,227,227,0,0,6.612334801762114,0.3003781528985249
18,246,246,0,0,0,10.987804878048781,0.25699352911895923
19,0,232,232,0,0,6.931034482758621,0.2722794446932367
20,231,231,0,0,0,9.303030303030303,0.2469038208168691
21,38,232,194,0,0,7.573275862068965,0.2976377071204671
22,0,233,233,0,0,6.030042918454936,0.2878866360811038
23,195,232,37,0,0,8.418103448275861,0.27032019704434096
24,0,242,242,0,0,6.851239669421488,0.25993621617914164
25,3,231,228,0,0,7.112554112554113,0.2916243177112768
26,241,241,0,0,0,9.356846473029046,0.24713001383126235
27,239,239,0,0,0,10.98326359832636,0.3442565310643131
28,39,236,197,0,0,7.559322033898305,0.26455102776775713
29,243,243,0,0,0,10.991769547325102,0.28092371526714893
30,1,230,229,0,0,6.826086956521739,0.2578317827985588
31,238,238,0,0,0,10.109243697478991,0.2580576534411243
32,2,242,240,0,0,6.68595041322314,0.2827063543774248
33,234,234,0,0,0,10.495726495726496,0.28538938410183073
34,0,243,243,0,0,6.189300411522634,0.23674454987586382
35,0,240,240,0,0,6.591666666666667,0.27608089260809027
36,232,232,0,0,0,10.331896551724139,0.2919652186893626
37,242,242,0,0,0,9.958677685950413,0.20575426082782297
38,0,230,230,0,0,6.021739130434782,0.318302639073476
39,1,227,226,0,0,6.762114537444934,0.28829285407975913
40,69,239,170,0,0,7.702928870292887,0.2769241587848534
41,6,244,238,0,0,7.19672131147541,0.273898670984284
42,51,235,184,0,0,7.553191489361702,0.29950900163666483
43,2,242,240,0,0,6.913223140495868,0.30364185041665326
44,2,240,238,0,0,7.020833333333333,0.27989888423989095
45,9,244,235,0,0,7.245901639344262,0.2931930108614983
46,6,240,234,0,0,7.175,0.2621338912133876
47,47,235,188,0,0,7.617021276595745,0.29714493544281106
48,80,237,157,0,0,7.8354430379746836,0.23975541729242975
49,2,227,225,0,0,6.947136563876652,0.244980702506724
50,1,228,227,0,0,6.868421052631579,0.2645490377927163
51,242,242,0,0,0,10.909090909090908,0.2821576763485477
52,237,237,0,0,0,9.19409282700422,0.2672530930415525
53,0,239,239,0,0,6.807531380753138,0.24851446854892642
54,18,236,218,0,0,7.313559322033898,0.27573025604038737
55,231,244,13,0,0,8.618852459016393,0.30268838966470485
56,1,237,236,0,0,6.780590717299578,0.2906386326253288
57,245,245,0,0,0,11.020408163265307,0.25777852124455886
58,53,227,174,0,0,7.674008810572687,0.2737904954972498
59,243,243,0,0,0,9.94238683127572,0.30245213073495575
60,92,239,147,0,0,7.924686192468619,0.3304384515312365
61,244,244,0,0,0,10.64344262295082,0.2879815152128412
62,239,239,0,0,0,10.506276150627615,0.2930276713195781
63,231,231,0,0,0,10.06060606060606,0.283267457180504
64,0,243,243,0,0,6.604938271604938,0.24823997551270585
65,19,237,218,0,0,7.514767932489452,0.2762640348995219
66,247,247,0,0,0,10.704453441295547,0.30660610249827636
67,0,232,232,0,0,6.163793103448276,0.2674279743245263
68,0,227,227,0,0,6.572687224669603,0.2634984990838541
69,0,228,228,0,0,6.105263157894737,0.2619986088569458
70,246,246,0,0,0,9.979674796747968,0.2648913223826064
71,16,242,226,0,0,7.413223140495868,0.2683721408730848
72,0,243,243,0,0,6.481481481481482,0.26721763085399197
73,0,235,235,0,0,6.314893617021276,0.2679396253864373
74,231,231,0,0,0,9.294372294372295,0.2434029738377633
75,0,232,232,0,0,6.047413793103448,0.2358374384236464
76,10,238,228,0,0,7.205882352941177,0.24857284686026535
77,5,242,237,0,0,7.115702479338843,0.26041630945440813
78,231,231,0,0,0,9.86147186147186,0.2589873894221692
79,230,230,0,0,0,10.478260869565217,0.30301879627872413
80,0,239,239,0,0,6.836820083682008,0.3135965683344495
81,32,232,200,0,0,7.616379310344827,0.2980855351545031
82,0,244,244,0,0,6.077868852459017,0.25317074816164437
83,0,236,236,0,0,6.0508474576271185,0.28676523620627625
84,241,242,1,0,0,8.950413223140496,0.26309111484516806
85,238,238,0,0,0,10.378151260504202,0.27833918377477146
86,207,244,37,0,0,8.430327868852459,0.25438507724481907
87,90,233,143,0,0,7.92274678111588,0.26124759508657636
88,3,237,234,0,0,7.109704641350211,0.28452406493599514
89,239,239,0,0,0,9.648535564853557,0.2709117119651209
90,70,239,169,0,0,7.803347280334728,0.2594845469568573
91,0,237,237,0,0,6.286919831223629,0.2732603876135295
92,0,233,233,0,0,6.257510729613734,0.3213334319964517
93,225,228,3,0,0,8.807017543859649,0.31501661643094464
94,56,231,175,0,0,7.740259740259741,0.25398080180689053
95,7,233,226,0,0,7.296137339055794,0.21795915347047412
96,247,247,0,0,0,10.809716599190283,0.2685230900891971
97,245,245,0,0,0,10.444897959183674,0.28076279692204925
98,0,243,243,0,0,6.037037037037037,0.25895316804407464
99,0,239,239,0,0,6.142259414225942,0.25698815090890237
100,157,244,87,0,0,8.155737704918034,0.29663360993051313
101,13,232,219,0,0,7.297413793103448,0.28778549037169837
102,2,238,236,0,0,7.092436974789916,0.24458390951317577
103,0,235,235,0,0,6.314893617021276,0.25939261683942877
104,139,233,94,0,0,8.111587982832617,0.22025307088944734
105,102,229,127,0,0,7.9825327510917035,0.27162338159809896
106,231,231,0,0,0,10.497835497835498,0.30325616412573375
107,122,231,109,0,0,8.047619047619047,0.3064182194616992
108,0,228,228,0,0,6.100877192982456,0.24969085709869035
109,37,233,196,0,0,7.579399141630901,0.26198756844753696
110,1,230,229,0,0,6.895652173913043,0.25107271691665145
111,234,234,0,0,0,9.311965811965813,0.3014012692124295
112,246,246,0,0,0,10.776422764227643,0.272258171561303
113,0,230,230,0,0,5.991304347826087,0.3230681602430251
114,73,245,172,0,0,7.816326530612245,0.2407159585145564
115,54,236,182,0,0,7.716101694915254,0.2722502704652025
116,0,234,234,0,0,6.170940170940171,0.24533215949524728
117,3,232,229,0,0,7.142241379310345,0.2870391103149743
118,82,240,158,0,0,7.8125,0.26176778242677823
119,42,228,186,0,0,7.614035087719298,0.28209289744184024
120,0,234,234,0,0,6.017094017094017,0.29155203404130087
121,235,235,0,0,0,9.13191489361702,0.31158392434987875
122,221,236,15,0,0,8.65677966101695,0.3029751172015862
123,230,230,0,0,0,10.034782608695652,0.269527245111061
124,0,231,231,0,0,6.926406926406926,0.27716920760398667
125,2,240,238,0,0,6.983333333333333,0.22566248256624472
126,0,231,231,0,0,6.298701298701299,0.27995482778091096
127,0,236,236,0,0,6.385593220338983,0.2634511359538397
128,160,240,80,0,0,8.241666666666667,0.27608089260809027
129,0,240,240,0,0,6.4875,0.29273012552301103
130,0,230,230,0,0,6.647826086956521,0.2640782228972887
131,21,235,214,0,0,7.468085106382978,0.25859247135842733
132,245,245,0,0,0,9.918367346938776,0.2801940448310487
133,20,235,215,0,0,7.463829787234043,0.266848517912348
134,25,238,213,0,0,7.504201680672269,0.2763535794064437
135,0,227,227,0,0,5.995594713656388,0.23449378191883552
136,1,234,233,0,0,6.829059829059829,0.2624995414694962
137,0,232,232,0,0,6.146551724137931,0.2728019107329428
138,41,227,186,0,0,7.629955947136564,0.26069159097110906
139,235,238,3,0,0,8.899159663865547,0.25983051448427524
140,232,232,0,0,0,10.857758620689655,0.26106508434094045
141,233,233,0,0,0,10.660944206008583,0.25954565635637317
142,3,232,229,0,0,7.012931034482759,0.25524331989849586
143,243,245,2,0,0,9.020408163265307,0.27417196386750964
144,21,239,218,0,0,7.355648535564853,0.2385288843570914
145,35,245,210,0,0,7.616326530612245,0.2784208765473388
146,1,241,240,0,0,6.576763485477178,0.3034578146611314
147,0,236,236,0,0,6.216101694915254,0.32331410025243656
148,0,236,236,0,0,6.453389830508475,0.274413992066354
149,164,243,79,0,0,8.222222222222221,0.30578512396694213
150,0,237,237,0,0,6.755274261603375,0.28731316598726664
151,13,235,222,0,0,7.357446808510638,0.2733951627568685
152,1,233,232,0,0,6.8412017167381975,0.24622613585910555
153,6,230,224,0,0,7.3,0.2807860262008702
154,0,232,232,0,0,6.181034482758621,0.2701149425287345
155,41,237,196,0,0,7.569620253164557,0.28856468568976534
156,0,238,238,0,0,6.563025210084033,0.2808211892351889
157,236,236,0,0,0,10.61864406779661,0.2624594302199802
158,0,227,227,0,0,6.167400881057269,0.25503878991072365
159,220,237,17,0,0,8.561181434599156,0.2811985982979407
160,0,230,230,0,0,6.004347826086956,0.27509018416555975
161,0,227,227,0,0,6.299559471365638,0.2726989201200761
162,90,234,144,0,0,7.867521367521367,0.2699277355929705
163,6,242,236,0,0,7.1735537190082646,0.235314289633418
164,0,237,237,0,0,6.628691983122363,0.2852749767574913
165,103,234,131,0,0,7.85042735042735,0.2736693444847942
166,0,239,239,0,0,6.7280334728033475,0.3500931753454502
167,0,231,231,0,0,6.298701298701299,0.2712591756069979
168,5,243,238,0,0,7.238683127572016,0.28163792810257354
169,0,240,240,0,0,6.316666666666666,0.3260808926080857
170,8,231,223,0,0,7.294372294372295,0.3303594955768858
171,79,230,151,0,0,7.8,0.23930131004366495
172,1,242,241,0,0,6.8264462809917354,0.28510682075374993
173,0,234,234,0,0,6.47008547008547,0.2845090055390459
174,48,241,193,0,0,7.6929460580912865,0.2636583679114816
175,32,234,202,0,0,7.564102564102564,0.255529877847472
176,234,234,0,0,0,9.2008547008547,0.247037892960636
177,0,236,236,0,0,6.406779661016949,0.2678687342228628
178,208,234,26,0,0,8.482905982905983,0.26794688382671644
179,1,244,243,0,0,6.971311475409836,0.27489374620522294
180,0,241,241,0,0,6.481327800829876,0.2756915629322293
181,238,242,4,0,0,8.863636363636363,0.25933609958506226
182,0,228,228,0,0,6.543859649122807,0.27560089651440983
183,237,237,0,0,0,10.924050632911392,0.24844453979832165
184,69,236,167,0,0,7.771186440677966,0.2963577353047204
185,5,244,239,0,0,7.274590163934426,0.2658537408082069
186,0,234,234,0,0,6.358974358974359,0.308352591614396
187,0,231,231,0,0,6.753246753246753,0.2649350649350669
188,12,234,222,0,0,7.3931623931623935,0.28252815377279183
189,0,230,230,0,0,6.1869565217391305,0.30987279286120895
190,0,233,233,0,0,5.969957081545064,0.2620245671155866
191,12,244,232,0,0,7.344262295081967,0.2595965728934761
192,4,242,238,0,0,7.119834710743802,0.2801858646822793
193,237,242,5,0,0,8.698347107438016,0.27792256781317537
194,236,236,0,0,0,10.830508474576272,0.24349080418319222
195,14,226,212,0,0,7.420353982300885,0.2980727630285158
196,244,244,0,0,0,9.192622950819672,0.2631552317344721
197,14,228,214,0,0,7.368421052631579,0.2777648968235533
198,10,241,231,0,0,7.410788381742739,0.29304979253111774
199,0,234,234,0,0,6.713675213675214,0.2996405120868677
200,239,241,2,0,0,9.228215767634854,0.3518672199170093
201,1,239,238,0,0,6.895397489539749,0.26212158503568855
202,230,230,0,0,0,9.26086956521739,0.24606037592557226
203,0,229,229,0,0,6.03056768558952,0.29292116754768677
204,0,228,228,0,0,6.276315789473684,0.25370971481567567
205,0,237,237,0,0,6.371308016877637,0.2683258242151184
206,222,233,11,0,0,8.721030042918455,0.25373686547284485
207,14,240,226,0,0,7.4125,0.2768305439330559
208,0,228,228,0,0,6.2105263157894735,0.22861117551588095
209,57,239,182,0,0,7.707112970711297,0.2583945712176119
210,28,241,213,0,0,7.531120331950207,0.283402489626557
211,244,244,0,0,0,9.10655737704918,0.2766646427848577
212,0,241,241,0,0,6.037344398340249,0.2527662517289097
213,0,242,242,0,0,6.008264462809917,0.2820890915949371
214,0,239,239,0,0,5.99581589958159,0.25628494075454383
215,2,237,235,0,0,6.9113924050632916,0.284488307230207
216,241,241,0,0,0,10.742738589211617,0.2585408022130044
217,230,231,1,0,0,8.965367965367966,0.28575192923018894
218,13,242,229,0,0,7.338842975206612,0.32454305407908013
219,0,232,232,0,0,6.844827586206897,0.2528735632183873
220,0,244,244,0,0,6.762295081967213,0.256021048370776
221,19,227,208,0,0,7.405286343612334,0.30404272737904753
222,246,246,0,0,0,10.825203252032521,0.2917703666832513
223,1,233,232,0,0,6.918454935622318,0.2907355335207896
224,226,231,5,0,0,8.909090909090908,0.24822134387351347
225,0,239,239,0,0,6.656903765690377,0.28515171759080343
226,105,239,134,0,0,7.953974895397489,0.2625786716360212
227,0,234,234,0,0,6.329059829059829,0.2989802281647752
228,84,239,155,0,0,7.861924686192468,0.27077106993425226
229,239,243,4,0,0,8.851851851851851,0.2672176308539995
230,2,242,240,0,0,7.095041322314049,0.26893796509036266
231,27,235,208,0,0,7.468085106382978,0.30132751409347003
232,233,245,12,0,0,8.661224489795918,0.3068919371027106
233,1,242,241,0,0,6.764462809917355,0.28039161894311104
234,242,243,1,0,0,9.11111111111111,0.2644628099173554
235,2,237,235,0,0,7.008438818565401,0.29653865407995694
236,0,228,228,0,0,6.728070175438597,0.2693407527629637
237,201,233,32,0,0,8.407725321888412,0.28562971733017234
238,0,239,239,0,0,6.531380753138075,0.25846489223304236
239,7,230,223,0,0,7.269565217391304,0.32003037782418703
240,223,231,8,0,0,8.722943722943723,0.31421042725391013
241,0,227,227,0,0,6.013215859030837,0.29628474523410536
242,12,235,223,0,0,7.251063829787234,0.2913984360792843
243,242,242,0,0,0,9.367768595041323,0.29157093378141713
244,8,237,229,0,0,7.345991561181434,0.3035114067081433
245,4,235,231,0,0,7.127659574468085,0.2485906528459715
246,16,239,223,0,0,7.401673640167364,0.25814844766358597
247,36,228,192,0,0,7.587719298245614,0.2874256124893735
248,244,244,0,0,0,9.938524590163935,0.24723402819941884
249,0,238,238,0,0,6.2100840336134455,0.2510371237102411
250,0,234,234,0,0,6.7905982905982905,0.2521000696966369
251,0,237,237,0,0,6.649789029535865,0.3302224129299895
252,28,242,214,0,0,7.479338842975206,0.2838037104351715
253,0,228,228,0,0,6.385964912280702,0.28209289744184024
254,237,237,0,0,0,10.717299578059071,0.22906386326252748
255,1,230,229,0,0,7.026086956521739,0.3224606037592543
256,222,238,16,0,0,8.684873949579831,0.2842428110484683
257,246,246,0,0,0,10.390243902439025,0.2879044300647142
258,0,231,231,0,0,6.688311688311688,0.29373235460192043
259,3,234,231,0,0,7.081196581196581,0.2294303217050025
260,52,241,189,0,0,7.659751037344399,0.2670816044260012
261,1,242,241,0,0,6.793388429752066,0.26418847090291475
262,69,229,160,0,0,7.794759825327511,0.286639086799967
263,3,230,227,0,0,7.095652173913043,0.279020315169925
264,228,234,6,0,0,8.850427350427351,0.2736693444847942
265,47,229,182,0,0,7.615720524017467,0.2902780969892008
266,246,246,0,0,0,9.130081300813009,0.2850506056080975
267,1,232,231,0,0,6.788793103448276,0.26255784445439645
268,27,241,214,0,0,7.535269709543568,0.30812586445366225
269,0,233,233,0,0,6.665236051502146,0.24951901731537873
270,101,234,133,0,0,7.897435897435898,0.22977880488609861
271,173,246,73,0,0,8.276422764227643,0.29878878380620094
272,4,233,229,0,0,7.133047210300429,0.2968773124167565
273,0,231,231,0,0,6.489177489177489,0.26836062488236284
274,98,230,132,0,0,7.969565217391304,0.33531422061894683
275,0,231,231,0,0,6.683982683982684,0.2431771127423338
276,227,242,15,0,0,8.599173553719009,0.2660574054387635
277,0,230,230,0,0,6.743478260869566,0.27015378773495685
278,60,227,167,0,0,7.713656387665198,0.2672020583992801
279,0,237,237,0,0,6.527426160337553,0.2672530930415525
280,14,237,223,0,0,7.383966244725738,0.2883858971608403
281,0,233,233,0,0,6.206008583690987,0.2073775344087592
282,16,227,211,0,0,7.3744493392070485,0.2795212662274339
283,133,229,96,0,0,8.056768558951966,0.28185091549834906
284,0,238,238,0,0,5.945378151260504,0.32189837960500683
285,229,229,0,0,0,9.851528384279476,0.30242089941009653
286,0,241,241,0,0,6.1078838174273855,0.27997925311202987
287,177,229,52,0,0,8.314410480349345,0.3042212518195029
288,28,233,205,0,0,7.493562231759657,0.25103596270534173
289,0,243,243,0,0,6.411522633744856,0.2844947794442719
290,239,239,0,0,0,10.06276150627615,0.3027671319573796
291,4,236,232,0,0,7.080508474576271,0.2615759105661709
292,0,243,243,0,0,6.390946502057613,0.2804135632418478
293,72,231,159,0,0,7.805194805194805,0.27927724449463825
294,0,241,241,0,0,6.356846473029045,0.27213001383126234
295,2,233,231,0,0,7.214592274678112,0.32444132011247695
296,229,234,5,0,0,8.816239316239317,0.2450570411943741
297,28,244,216,0,0,7.475409836065574,0.26688254739256906
298,4,229,225,0,0,7.122270742358078,0.28322990883321963
299,0,227,227,0,0,6.3039647577092515,0.2921523527347825
300,4,231,227,0,0,7.134199134199134,0.2645209862601168
301,66,227,161,0,0,7.788546255506608,0.2913726560368036
302,237,237,0,0,0,10.89451476793249,0.2727240220267542
303,0,238,238,0,0,6.205882352941177,0.265450483991067
304,0,230,230,0,0,6.008695652173913,0.24446554015568883
305,238,238,0,0,0,10.050420168067227,0.2674892741906891
306,45,232,187,0,0,7.655172413793103,0.2701895805344046
307,0,235,235,0,0,5.902127659574468,0.24251682124022564
308,107,232,125,0,0,7.974137931034483,0.25041050903119705
309,232,232,0,0,0,10.008620689655173,0.2942976563666165
310,77,244,167,0,0,7.766393442622951,0.28676718612966656
311,113,239,126,0,0,7.97489539748954,0.29348475791990314
312,15,232,217,0,0,7.431034482758621,0.2982534706672627
313,3,242,239,0,0,7.235537190082645,0.2720928637563891
314,5,232,227,0,0,7.099137931034483,0.3061464397671278
315,0,240,240,0,0,6.304166666666666,0.2878486750348685
316,0,230,230,0,0,6.2043478260869565,0.31177140687298177
317,0,239,239,0,0,6.2133891213389125,0.260996448788724
318,243,244,1,0,0,8.889344262295081,0.23050327194225412
319,0,238,238,0,0,6.80672268907563,0.2916001843775508
320,243,243,0,0,0,9.45679012345679,0.2987450260177505
321,242,242,0,0,0,10.78099173553719,0.2962346970268462
322,1,231,230,0,0,6.922077922077922,0.2373800112930558
323,71,244,173,0,0,7.778688524590164,0.28003777912703365
324,4,228,224,0,0,7.175438596491228,0.2862663266094764
325,0,243,243,0,0,6.497942386831276,0.3006155834438672
326,105,229,124,0,0,7.956331877729258,0.31387420516356496
327,78,242,164,0,0,7.797520661157025,0.3032303418949973
328,111,237,126,0,0,7.962025316455696,0.29092469427161816
329,0,241,241,0,0,6.850622406639004,0.24426002766251714
330,0,237,237,0,0,6.059071729957806,0.3015804905957246
331,0,236,236,0,0,6.38135593220339,0.27097006851785255
332,248,248,0,0,0,10.64516129032258,0.270340864568366
333,4,241,237,0,0,7.012448132780083,0.27067773167358006
334,119,242,123,0,0,8.049586776859504,0.26309111484516806
335,238,238,0,0,0,9.449579831932773,0.2738183881147397
336,48,228,180,0,0,7.671052631578948,0.3010085787155142
337,50,233,183,0,0,7.6995708154506435,0.2628015391445889
338,227,232,5,0,0,8.857758620689655,0.3130131362889924
339,69,237,168,0,0,7.751054852320675,0.27250947579203333
340,232,232,0,0,0,10.431034482758621,0.28093745335124537
341,0,230,230,0,0,6.2,0.26550218340611037
342,0,228,228,0,0,6.600877192982456,0.30255429322203836
343,116,231,115,0,0,7.926406926406926,0.2597779032561606
344,1,232,231,0,0,6.892241379310345,0.19180101507687905
345,245,245,0,0,0,9.375510204081632,0.26825025092003657
346,0,231,231,0,0,6.658008658008658,0.2781855825334076
347,42,243,201,0,0,7.604938271604938,0.30609121518212734
348,40,242,202,0,0,7.603305785123967,0.29011350776722433
349,0,235,235,0,0,6.859574468085106,0.28361520276414215
350,0,231,231,0,0,6.298701298701299,0.2538678712591718
351,0,228,228,0,0,6.359649122807017,0.3106113300873323
352,13,231,218,0,0,7.346320346320346,0.2795407491059687
353,234,234,0,0,0,10.495726495726496,0.25105462015333285
354,1,238,237,0,0,6.991596638655462,0.21089954969329291
355,244,244,0,0,0,9.94672131147541,0.26463941172501726
356,0,242,242,0,0,6.884297520661157,0.26871506464113015
357,124,230,106,0,0,8.004347826086956,0.24888931080311436
358,8,245,237,0,0,7.338775510204082,0.2904984944797598
359,0,231,231,0,0,6.090909090909091,0.3264822134387388
360,0,239,239,0,0,6.292887029288703,0.2836046552512253
361,0,238,238,0,0,6.420168067226891,0.2699712796510988
362,0,241,241,0,0,5.970954356846473,0.261652835408025
363,0,231,231,0,0,6.896103896103896,0.29350649350649094
364,235,235,0,0,0,9.736170212765957,0.2890707401345733
365,66,234,168,0,0,7.82051282051282,0.2509078903928713
366,0,230,230,0,0,6.434782608695652,0.2468198215302798
367,245,245,0,0,0,10.379591836734694,0.2610572097691609
368,219,237,18,0,0,8.518987341772151,0.259171851534012
369,0,242,242,0,0,6.595041322314049,0.30005829704057013
370,37,234,197,0,0,7.581196581196581,0.2959539268552171
371,0,241,241,0,0,6.087136929460581,0.26320885200553523
372,0,227,227,0,0,6.334801762114537,0.27679232778449564
373,0,232,232,0,0,6.482758620689655,0.27675772503358903
374,241,241,0,0,0,10.975103734439834,0.3577109266943353
375,116,230,114,0,0,7.995652173913044,0.29255743307385673
376,46,242,196,0,0,7.619834710743802,0.2615136655121548
377,243,243,0,0,0,10.407407407407407,0.28374655647383423
378,222,229,7,0,0,8.799126637554584,0.27526239178732476
379,231,231,0,0,0,10.056277056277056,0.36638434029738837
380,86,229,143,0,0,7.88646288209607,0.22389489006358768
381,86,237,151,0,0,7.780590717299578,0.2821640563541423
382,22,241,219,0,0,7.468879668049793,0.2750691562932237
383,29,230,201,0,0,7.565217391304348,0.29048794380102216
384,0,235,235,0,0,6.834042553191489,0.24157119476268024
385,2,236,234,0,0,6.936440677966102,0.25551749008294056
386,239,239,0,0,0,9.615062761506277,0.24615871453184016
387,240,240,0,0,0,10.054166666666667,0.26902022315202334
388,242,242,0,0,0,9.351239669421487,0.2952059257227101
389,0,233,233,0,0,6.407725321888412,0.25114695870948267
390,6,236,230,0,0,7.148305084745763,0.2800396682293525
391,15,235,220,0,0,7.370212765957447,0.2768867066739388
392,1,244,243,0,0,6.684426229508197,0.27448896984415977
393,34,234,200,0,0,7.564102564102564,0.26411356883459647
394,244,244,0,0,0,10.663934426229508,0.2651959792214848
395,174,237,63,0,0,8.367088607594937,0.3180647929628907
396,0,228,228,0,0,6.578947368421052,0.27127289589613096
397,2,245,243,0,0,6.828571428571428,0.2901639344262265
398,235,235,0,0,0,9.429787234042553,0.27175850154573056
399,247,247,0,0,0,10.03238866396761,0.3160198808465823
400,0,237,237,0,0,6.451476793248945,0.27411857255238226
401,239,239,0,0,0,9.761506276150628,0.2664111669772475
402,0,227,227,0,0,6.343612334801762,0.27963822073213596
403,244,244,0,0,0,10.495901639344263,0.3250860149767246
404,0,241,241,0,0,6.564315352697095,0.27188796680497945
405,0,234,234,0,0,7.1239316239316235,0.23779391805142686
406,91,245,154,0,0,7.918367346938775,0.2883907661425241
407,244,244,0,0,0,10.352459016393443,0.2703231464615839
408,208,237,29,0,0,8.48945147679325,0.26789673174569206
409,241,241,0,0,0,9.775933609958507,0.29125172890732454
410,231,231,0,0,0,10.406926406926408,0.28586485977790765
411,48,236,188,0,0,7.682203389830509,0.2943202307969725
412,239,239,0,0,0,10.644351464435147,0.3057557751133939
413,48,239,191,0,0,7.631799163179917,0.25041313596568004
414,64,246,182,0,0,7.760162601626016,0.2728554836568798
415,1,228,227,0,0,6.87280701754386,0.3053365793337931
416,238,238,0,0,0,10.554621848739496,0.27337517285395196
417,193,239,46,0,0,8.338912133891213,0.2838156182975321
418,0,243,243,0,0,6.102880658436214,0.27449579974832766
419,238,238,0,0,0,10.315126050420169,0.250487536786865
420,3,232,229,0,0,6.978448275862069,0.2636027765338086
421,0,239,239,0,0,6.686192468619247,0.2750606518758112
422,2,244,242,0,0,7.073770491803279,0.2826013627470832
423,0,239,239,0,0,6.497907949790795,0.26785274779367607
424,4,244,240,0,0,7.069672131147541,0.26261552991971615
425,5,242,237,0,0,7.12396694214876,0.31651863790679297
426,230,233,3,0,0,8.909871244635193,0.24615213852301418
427,0,226,226,0,0,6.030973451327434,0.2968141592920357
428,42,241,199,0,0,7.601659751037344,0.307330567081605
429,233,233,0,0,0,10.660944206008583,0.3112697942874077
430,1,238,237,0,0,7.109243697478991,0.26649647200652515
431,241,241,0,0,0,10.630705394190871,0.267219917012441
432,0,242,242,0,0,6.06198347107438,0.25755289599122483
433,180,231,51,0,0,8.32034632034632,0.2969320534537948
434,160,245,85,0,0,8.187755102040816,0.2924723987955792
435,87,235,148,0,0,7.842553191489362,0.27852336788506893
436,237,237,0,0,0,9.856540084388186,0.26746763927626566
437,0,244,244,0,0,6.012295081967213,0.2508770154489653
438,0,226,226,0,0,6.265486725663717,0.2847590953785645
439,0,237,237,0,0,6.30801687763713,0.28184223700207256
440,40,229,189,0,0,7.5895196506550215,0.2956791542174199
441,0,237,237,0,0,6.40084388185654,0.2750840306085993
442,2,238,236,0,0,6.9789915966386555,0.24006311385313633
443,30,230,200,0,0,7.465217391304348,0.2935447123599773
444,0,242,242,0,0,6.512396694214876,0.29237680463632826
445,101,229,128,0,0,7.995633187772926,0.31138435608672327
446,136,228,92,0,0,8.052631578947368,0.20867145838163734
447,11,237,226,0,0,7.291139240506329,0.25809912036043836
448,0,230,230,0,0,6.5,0.2685589519650655
449,237,237,0,0,0,9.451476793248945,0.30801687763713576
450,235,235,0,0,0,10.093617021276597,0.2476086561192872
451,0,242,242,0,0,6.731404958677686,0.25535818387572395
452,160,238,78,0,0,8.184873949579831,0.2779136971244177
453,106,232,126,0,0,7.896551724137931,0.2576503955814276
454,236,236,0,0,0,10.292372881355933,0.26734583483591856
455,27,244,217,0,0,7.459016393442623,0.257572691088175
456,0,241,241,0,0,7.037344398340249,0.2527662517289097
457,12,230,218,0,0,7.386956521739131,0.28192519460793547
458,240,241,1,0,0,8.995850622406639,0.23748271092669407
459,92,231,139,0,0,7.926406926406926,0.338038772821378
460,3,233,230,0,0,7.055793991416309,0.24256326772235987
461,231,242,11,0,0,8.685950413223141,0.2744075991906953
462,120,242,122,0,0,7.987603305785124,0.2778539830595648
463,235,235,0,0,0,10.557446808510639,0.281942171303877
464,242,243,1,0,0,9.469135802469136,0.2748699112335465
465,51,244,193,0,0,7.676229508196721,0.2774573298252725
466,1,242,241,0,0,6.859504132231405,0.2872329481156327
467,0,244,244,0,0,6.557377049180328,0.2888753963435181
468,232,232,0,0,0,9.336206896551724,0.2674279743245184
469,0,242,242,0,0,6.305785123966942,0.2795514557113984
470,0,235,235,0,0,6.3319148936170215,0.2568830696490272
471,0,230,230,0,0,6.6347826086956525,0.24157964685779545
472,240,240,0,0,0,9.6125,0.2885460251046086
473,233,233,0,0,0,10.167381974248928,0.2520349267426417
474,190,241,51,0,0,8.33195020746888,0.2643499308437034
475,34,228,194,0,0,7.574561403508772,0.2807597186799609
476,105,230,125,0,0,7.917391304347826,0.2769887981773326
477,11,228,217,0,0,7.298245614035087,0.2807017543859669
478,117,243,126,0,0,8.012345679012345,0.2519130700948905
479,0,231,231,0,0,6.510822510822511,0.2770562770562759
480,1,238,237,0,0,6.88655462184874,0.2866539020671576
481,2,237,235,0,0,7.113924050632911,0.32171207895301496
482,11,243,232,0,0,7.31275720164609,0.3397952589871802
483,1,238,237,0,0,6.945378151260504,0.2543878310818001
484,124,228,104,0,0,7.995614035087719,0.2510820001545717
485,0,236,236,0,0,6.1440677966101696,0.28553912729895525
486,245,245,0,0,0,10.126530612244897,0.2257276681164244
487,0,234,234,0,0,6.521367521367521,0.30211657679468723
488,222,236,14,0,0,8.65677966101695,0.3029751172015862
489,0,227,227,0,0,6.26431718061674,0.2749600405442303
490,189,228,39,0,0,8.43859649122807,0.30017775716825
491,44,233,189,0,0,7.648068669527897,0.2635415125055496
492,0,236,236,0,0,5.970338983050848,0.3437973314100283
493,244,244,0,0,0,10.90983606557377,0.2881333063482455
494,0,228,228,0,0,6.381578947368421,0.26344771620681323
495,84,241,157,0,0,7.829875518672199,0.27510373443983555
496,240,240,0,0,0,10.775,0.27552301255229517
497,35,235,200,0,0,7.591489361702128,0.2768503364248038
498,20,243,223,0,0,7.42798353909465,0.2788831071659369
499,6,238,232,0,0,7.214285714285714,0.2787823990355669
500,1,243,242,0,0,7.065843621399177,0.26837397544468405
501,147,241,94,0,0,8.161825726141078,0.261203319502071
502,0,244,244,0,0,6.639344262295082,0.280914794575999
503,73,242,169,0,0,7.756198347107438,0.2930112136072167
504,0,234,234,0,0,6.102564102564102,0.24694618686034756
505,161,231,70,0,0,8.225108225108226,0.28823640127988176
506,243,244,1,0,0,9.221311475409836,0.29649868447682043
507,61,242,181,0,0,7.714876033057851,0.2959603580124114
508,36,238,202,0,0,7.584033613445378,0.2608410452788731
509,234,234,0,0,0,9.585470085470085,0.2780712372987026
510,11,230,219,0,0,7.217391304347826,0.25821150560090855
511,0,226,226,0,0,6.106194690265487,0.2731170108161233
512,64,245,181,0,0,7.702040816326531,0.30020073603211994
513,18,234,216,0,0,7.410256410256411,0.2773192472763294
514,27,237,210,0,0,7.518987341772152,0.2930701566187501
515,1,233,232,0,0,6.92274678111588,0.24400621577623152
516,0,232,232,0,0,6.5905172413793105,0.3121174802209282
517,0,227,227,0,0,6.154185022026431,0.29913063818174573
518,102,241,139,0,0,7.8921161825726145,0.2633125864453632
519,243,243,0,0,0,9.119341563786008,0.3038805564058049
520,0,229,229,0,0,6.641921397379913,0.26595418677698834
521,239,239,0,0,0,10.891213389121338,0.2822333954502349
522,231,242,11,0,0,8.669421487603305,0.26370837762765575
523,21,233,212,0,0,7.446351931330472,0.2999112031966825
524,27,231,204,0,0,7.528138528138528,0.26768304159608225
525,0,243,243,0,0,6.300411522633745,0.2854130530898199
526,96,237,141,0,0,7.894514767932489,0.29814775084030587
527,7,230,223,0,0,7.304347826086956,0.2650465160432922
528,104,238,134,0,0,7.953781512605042,0.3143105343403212
529,130,243,113,0,0,7.987654320987654,0.30149984695439463
530,0,231,231,0,0,6.70995670995671,0.28507434594390835
531,0,243,243,0,0,6.555555555555555,0.2975206611570248
532,0,241,241,0,0,6.215767634854772,0.2949170124481346
533,0,233,233,0,0,6.407725321888412,0.29425040698534477
534,234,234,0,0,0,9.790598290598291,0.26926745167088584
535,74,229,155,0,0,7.777292576419214,0.2703593043744756
536,0,246,246,0,0,6.650406504065041,0.2854488136718104
537,0,234,234,0,0,6.670940170940171,0.25606177322915286
538,245,245,0,0,0,10.551020408163266,0.2811977249916336
539,240,240,0,0,0,10.875,0.3190376569037657
540,69,233,164,0,0,7.815450643776824,0.27182921414829125
541,234,234,0,0,0,10.213675213675213,0.27174351637870536
542,0,244,244,0,0,6.795081967213115,0.21297982864467455
543,0,235,235,0,0,6.323404255319149,0.2966721222040403
544,246,246,0,0,0,10.447154471544716,0.29719595155134926
545,135,243,108,0,0,8.024691358024691,0.22252831343740573
546,3,229,226,0,0,7.126637554585153,0.2777522408641664
547,0,228,228,0,0,6.258771929824562,0.24551742793106227
548,0,232,232,0,0,6.0,0.27705627705627706
549,110,242,132,0,0,7.979338842975206,0.294177154418574
550,247,247,0,0,0,10.65991902834008,0.30663901780718605
551,0,230,230,0,0,6.282608695652174,0.2647617239415199
552,3,237,234,0,0,6.89873417721519,0.2778373739540904
553,0,238,238,0,0,6.394957983193278,0.2821685636279861
554,14,232,218,0,0,7.405172413793103,0.28534109568591975
555,2,244,242,0,0,7.135245901639344,0.2902752479255203
556,4,233,229,0,0,7.266094420600858,0.2737161462187346
557,0,243,243,0,0,5.991769547325103,0.3222460293167357
558,236,236,0,0,0,10.533898305084746,0.30097367472052167
559,0,233,233,0,0,6.23175965665236,0.2736421488826432
560,7,230,223,0,0,7.1869565217391305,0.2749382950446151
561,0,228,228,0,0,6.592105263157895,0.2690122884303307
562,20,228,208,0,0,7.469298245614035,0.27658628951232483
563,0,229,229,0,0,6.598253275109171,0.276488163640543
564,6,230,224,0,0,7.208695652173913,0.3143345357888766
565,122,230,108,0,0,8.02608695652174,0.29625973039680886
566,3,232,229,0,0,7.103448275862069,0.2836244215554536
567,4,246,242,0,0,7.211382113821138,0.2571760411481703
568,245,245,0,0,0,10.914285714285715,0.29180327868852757
569,0,226,226,0,0,6.557522123893805,0.2655653883972506
570,236,236,0,0,0,10.686440677966102,0.2842408943382597
571,2,234,232,0,0,6.978632478632479,0.20984189868309927
572,231,234,3,0,0,9.008547008547009,0.2746047467077521
573,141,238,97,0,0,8.180672268907562,0.2667978583838565
574,4,231,227,0,0,7.151515151515151,0.25085638998682597
575,121,244,123,0,0,7.995901639344262,0.28393375160223905
576,20,233,213,0,0,7.450643776824034,0.30035518721326204
577,2,230,228,0,0,7.1,0.2301310043668154
578,1,242,241,0,0,6.801652892561983,0.23435410308288493
579,0,239,239,0,0,6.7531380753138075,0.2875426321156088
580,0,234,234,0,0,6.6923076923076925,0.2826015186530226
581,116,231,115,0,0,8.030303030303031,0.30777338603425247
582,50,231,181,0,0,7.675324675324675,0.3158667419536948
583,6,227,221,0,0,7.057268722466961,0.2931659584421656
584,100,228,128,0,0,7.881578947368421,0.31631115233016127
585,238,238,0,0,0,10.294117647058824,0.28443782576321125
586,25,243,218,0,0,7.534979423868313,0.2580689045335547
587,61,241,180,0,0,7.7012448132780085,0.28537344398340186
588,241,241,0,0,0,10.54356846473029,0.2824688796680524
589,0,237,237,0,0,6.856540084388186,0.25899306300507924
590,40,243,203,0,0,7.448559670781893,0.26490494167261536
591,127,240,113,0,0,7.983333333333333,0.3177126917712656
592,26,242,216,0,0,7.483471074380165,0.2922567813175154
593,0,228,228,0,0,6.618421052631579,0.25463714351958855
594,0,226,226,0,0,6.314159292035399,0.28753195673549875
595,26,238,212,0,0,7.495798319327731,0.30167003510264623
596,12,239,227,0,0,7.2677824267782425,0.24731901128652375
597,235,244,9,0,0,8.76639344262295,0.3114585441543579
598,0,243,243,0,0,6.765432098765432,0.2959902050811139
599,0,234,234,0,0,6.6752136752136755,0.2717435163787132
600,231,231,0,0,0,10.428571428571429,0.2981366459627284
601,0,243,243,0,0,5.97119341563786,0.2925551814440733
602,235,237,2,0,0,8.890295358649789,0.26757491239362224
603,237,237,0,0,0,9.848101265822784,0.2988629049560139
604,0,236,236,0,0,5.970338983050848,0.27571222502704956
605,0,232,232,0,0,6.206896551724138,0.3206448723690084
606,76,237,161,0,0,7.776371308016878,0.25062575985124935
607,6,240,234,0,0,7.158333333333333,0.24260808926080993
608,19,234,215,0,0,7.495726495726496,0.2596383111404573
609,0,226,226,0,0,6.84070796460177,0.24117994100295215
610,6,239,233,0,0,7.2761506276150625,0.2763615906613711
611,8,226,218,0,0,7.199115044247788,0.2668436578171127
612,8,237,229,0,0,7.274261603375527,0.2592076092397924
613,210,236,26,0,0,8.533898305084746,0.2924630364226493
614,0,227,227,0,0,6.572687224669603,0.29004717165022575
615,0,226,226,0,0,6.061946902654867,0.28058997050147605
616,0,229,229,0,0,6.580786026200873,0.2796292040143989
617,0,242,242,0,0,6.090909090909091,0.2987551867219917
618,29,237,208,0,0,7.586497890295359,0.268969462919258
619,0,238,238,0,0,6.310924369747899,0.3248590575470722
620,0,230,230,0,0,6.265217391304348,0.2655971141067038
621,26,240,214,0,0,7.458333333333333,0.29951185495118804
622,221,239,18,0,0,8.581589958158995,0.2779789740163797
623,6,235,229,0,0,7.229787234042553,0.2803055100927469
624,198,234,36,0,0,8.401709401709402,0.24995414694985577
625,132,238,106,0,0,8.029411764705882,0.3071481757259893
626,0,234,234,0,0,6.098290598290598,0.2521000696966369
627,11,230,219,0,0,7.239130434782608,0.278811467628629
628,127,244,117,0,0,8.024590163934427,0.22161505768063489
629,238,238,0,0,0,9.218487394957982,0.28117576144382217
630,245,245,0,0,0,9.506122448979593,0.27557711609234337
631,244,244,0,0,0,9.819672131147541,0.28833569452876967
632,233,233,0,0,0,9.206008583690988,0.2677223619949661
633,0,239,239,0,0,6.2803347280334725,0.29503182025948127
634,0,234,234,0,0,5.987179487179487,0.24447012215252797
635,197,236,39,0,0,8.402542372881356,0.2840786152181805
636,9,230,221,0,0,7.404347826086957,0.27683690905638786
637,50,244,194,0,0,7.663934426229508,0.25696552654658017
638,225,240,15,0,0,8.575,0.27887029288703535
639,8,236,228,0,0,7.2923728813559325,0.30989902632528027
640,10,240,230,0,0,7.308333333333334,0.24762900976289742
641,0,238,238,0,0,6.5966386554621845,0.27543169166400794
642,0,229,229,0,0,6.703056768558952,0.28863096606143873
643,0,243,243,0,0,6.078189300411522,0.2707206747610813
644,0,242,242,0,0,6.107438016528926,0.29546311854874413
645,102,231,129,0,0,7.987012987012987,0.27374364765669074
646,239,245,6,0,0,8.812244897959184,0.3006691201070546
647,0,241,241,0,0,6.174273858921162,0.2945020746888
648,0,238,238,0,0,6.915966386554622,0.3135836613126284
649,0,238,238,0,0,5.983193277310924,0.2613197177605211
650,2,233,231,0,0,7.008583690987124,0.2499260026639008
651,234,234,0,0,0,10.995726495726496,0.25320054290011396
652,233,233,0,0,0,10.738197424892704,0.2803019091312653
653,22,227,205,0,0,7.484581497797357,0.25086741257650547
654,243,244,1,0,0,9.19672131147541,0.306820481683865
655,234,245,11,0,0,8.657142857142857,0.300000000000003
656,231,231,0,0,0,9.87012987012987,0.2961038961039025
657,240,240,0,0,0,9.641666666666667,0.25599721059972513
658,36,241,205,0,0,7.593360995850622,0.2756224066390056
659,0,238,238,0,0,6.890756302521009,0.30025174626812856
660,240,240,0,0,0,8.904166666666667,0.3296896792189689
661,246,246,0,0,0,10.987804878048781,0.2814833250373266
662,0,234,234,0,0,6.589743589743589,0.3030703202377028
663,2,240,238,0,0,6.7375,0.3282949790794964
664,230,230,0,0,0,10.373913043478261,0.26132523258022294
665,78,235,157,0,0,7.8,0.2888888888888904
666,25,235,210,0,0,7.476595744680851,0.2590652845971981
667,246,246,0,0,0,10.483739837398375,0.2752447320391574
668,234,234,0,0,0,9.414529914529915,0.30382231026007595
669,0,231,231,0,0,6.3896103896103895,0.291022021456806
670,247,247,0,0,0,10.595141700404858,0.30696817089628303
671,0,237,237,0,0,6.0042194092827,0.26693127368948266
672,232,232,0,0,0,9.676724137931034,0.2630056724884246
673,6,229,223,0,0,6.943231441048035,0.3169386347965947
674,244,244,0,0,0,9.524590163934427,0.2998043580921575
675,197,234,37,0,0,8.38888888888889,0.25584167858845275
676,1,233,232,0,0,6.84549356223176,0.3036110700014778
677,108,232,124,0,0,7.961206896551724,0.32316390506045706
678,0,227,227,0,0,6.8061674008810575,0.28084675061401176
679,0,241,241,0,0,6.012448132780083,0.3373443983402467
680,191,244,53,0,0,8.40983606557377,0.27578762733589984
681,0,228,228,0,0,6.026315789473684,0.25481103640157876
682,0,238,238,0,0,6.5,0.27637130801687765
683,57,242,185,0,0,7.756198347107438,0.30130996879393873
684,0,237,237,0,0,6.2405063291139244,0.2851319459343466
685,0,240,240,0,0,6.75,0.29707112970711297
686,65,236,171,0,0,7.694915254237288,0.2809953119365286
687,118,237,119,0,0,8.0,0.2796610169491525
688,233,233,0,0,0,10.381974248927039,0.28019091312712435
689,239,239,0,0,0,9.774058577405858,0.31008051756267196
690,238,238,0,0,0,9.936974789915967,0.2787114845938387
691,244,244,0,0,0,10.397540983606557,0.2981009242393617
692,0,244,244,0,0,6.024590163934426,0.2709977737300176
693,230,230,0,0,0,10.065217391304348,0.27083728877919605
694,82,232,150,0,0,7.758620689655173,0.2878041498731178
695,234,235,1,0,0,9.08936170212766,0.24411711220221685
696,0,229,229,0,0,5.9825327510917035,0.35057075001915156
697,239,239,0,0,0,9.694560669456067,0.27186104567350533
698,0,228,228,0,0,6.587719298245614,0.2786150398021488
699,116,232,116,0,0,7.991379310344827,0.2942976563666243
700,12,240,228,0,0,7.3125,0.2994246861924686
701,15,239,224,0,0,7.397489539748954,0.2657079568228966
702,0,244,244,0,0,5.930327868852459,0.29553734061930464
703,40,235,195,0,0,7.685106382978724,0.2850336424804544
704,234,234,0,0,0,9.504273504273504,0.27680569311470626
705,238,238,0,0,0,9.508403361344538,0.3184944864021613
706,0,237,237,0,0,6.561181434599156,0.2896731745691194
707,5,229,224,0,0,7.296943231441048,0.2710871064123159
708,0,227,227,0,0,6.330396475770925,0.31955869166893985
709,208,229,21,0,0,8.528384279475983,0.2590592201026594
710,0,228,228,0,0,6.140350877192983,0.332637761805394
711,0,234,234,0,0,6.119658119658119,0.27746597703679093
712,42,242,200,0,0,7.62396694214876,0.2605020403964195
713,4,239,235,0,0,7.112970711297071,0.29390668401251674
714,22,227,205,0,0,7.475770925110132,0.28591477915091096
715,99,244,145,0,0,7.885245901639344,0.29130405450988245
716,5,229,224,0,0,7.152838427947598,0.27039760974488863
717,12,237,225,0,0,7.324894514767933,0.27111492526639763
718,232,243,11,0,0,8.716049382716049,0.26201408019590394
719,235,235,0,0,0,10.34468085106383,0.3379523549736358
720,0,234,234,0,0,6.384615384615385,0.2548695939253873
721,0,236,236,0,0,6.466101694915254,0.28395239812477696
722,6,234,228,0,0,7.213675213675214,0.2631598253915887
723,50,238,188,0,0,7.722689075630252,0.28564337127255973
724,241,241,0,0,0,9.145228215767634,0.2996542185338816
725,0,226,226,0,0,6.376106194690266,0.2712487708947851
726,95,233,138,0,0,7.948497854077253,0.23871540624537405
727,0,234,234,0,0,6.722222222222222,0.295898903195044
728,239,239,0,0,0,10.92468619246862,0.28001828346400964
729,247,247,0,0,0,10.259109311740891,0.2577926993844886
730,2,229,227,0,0,7.117903930131004,0.2974412012564132
731,238,238,0,0,0,10.647058823529411,0.29684785306528305
732,238,238,0,0,0,10.411764705882353,0.293869446512776
733,72,240,168,0,0,7.758333333333334,0.2593444909344501
734,232,232,0,0,0,10.452586206896552,0.2747984773846854
735,0,239,239,0,0,6.581589958158996,0.2527688899827739
736,7,241,234,0,0,7.257261410788382,0.2668741355463377
737,237,237,0,0,0,9.164556962025317,0.24822999356360848
738,238,238,0,0,0,9.739495798319327,0.26096514555189554
739,231,231,0,0,0,10.363636363636363,0.29328063241106145
740,241,241,0,0,0,10.037344398340249,0.2527662517289021
741,0,225,225,0,0,6.271111111111111,0.2699206349206357
742,0,237,237,0,0,6.109704641350211,0.2760494886648087
743,0,235,235,0,0,6.425531914893617,0.2796872158574283
744,39,230,191,0,0,7.539130434782609,0.2844883235238303
745,44,230,186,0,0,7.665217391304348,0.2935447123599773
746,93,228,135,0,0,7.982456140350878,0.21114460159208243
747,0,229,229,0,0,6.82532751091703,0.2763732475293038
748,0,241,241,0,0,6.273858921161826,0.274688796680501
749,3,238,235,0,0,7.092436974789916,0.28677800234017997
750,205,229,24,0,0,8.580786026200874,0.2796292040143989
751,0,230,230,0,0,6.2,0.3091703056768527
752,246,246,0,0,0,10.626016260162602,0.2595652895304404
753,23,233,210,0,0,7.454935622317596,0.2835207932514393
754,234,234,0,0,0,9.337606837606838,0.30184145849381405
755,9,240,231,0,0,7.35,0.26192468619247017
756,32,245,213,0,0,7.530612244897959,0.27467380394780955
757,10,236,226,0,0,7.279661016949152,0.25337179949513466
758,35,228,193,0,0,7.5964912280701755,0.2769920395702912
759,125,234,109,0,0,7.9743589743589745,0.29118520964014705
760,7,243,236,0,0,7.189300411522634,0.2945957895452853
761,0,238,238,0,0,6.315126050420168,0.2926816296138692
762,12,245,233,0,0,7.375510204081633,0.28464369354298735
763,83,237,154,0,0,7.772151898734177,0.2614245869985005
764,7,237,230,0,0,7.248945147679325,0.2979332046055927
765,39,233,194,0,0,7.618025751072961,0.29743229243746916
766,0,232,232,0,0,6.525862068965517,0.2850425436632317
767,0,241,241,0,0,6.3153526970954355,0.2751383125864474
768,236,236,0,0,0,9.63135593220339,0.33586368553912915
769,20,237,217,0,0,7.548523206751055,0.26564399628119584
770,0,227,227,0,0,6.158590308370044,0.30217145530388684
771,243,243,0,0,0,10.469135802469136,0.26660544842362915
772,0,230,230,0,0,6.378260869565217,0.2798746914752259
773,0,241,241,0,0,6.66390041493776,0.28239972337482866
774,0,238,238,0,0,6.659663865546219,0.27608765024997256
775,243,243,0,0,0,9.390946502057613,0.25562017481209576
776,1,229,228,0,0,6.755458515283843,0.32590209147322147
777,235,235,0,0,0,10.506382978723405,0.30230951082015434
778,0,226,226,0,0,6.597345132743363,0.2949262536873155
779,243,243,0,0,0,10.246913580246913,0.26936026936027324
780,234,234,0,0,0,10.623931623931623,0.2785664502402759
781,2,235,233,0,0,7.1191489361702125,0.24215311874886383
782,16,234,218,0,0,7.384615384615385,0.27203697589963627
783,127,242,115,0,0,8.02892561983471,0.26886938033675206
784,0,233,233,0,0,6.48068669527897,0.2938064229687731
785,0,230,230,0,0,6.6173913043478265,0.3071198025441432
786,0,234,234,0,0,6.8931623931623935,0.28467407651957294
787,2,241,239,0,0,6.75103734439834,0.3294260027662555
788,0,240,240,0,0,6.5125,0.2843619246861909
789,0,244,244,0,0,6.922131147540983,0.2614012008365415
790,6,238,232,0,0,7.281512605042017,0.29594369393326597
791,2,236,234,0,0,6.860169491525424,0.33355571583122856
792,0,239,239,0,0,6.062761506276151,0.31117049330192503
793,11,227,216,0,0,7.361233480176211,0.29371174613075646
794,36,234,198,0,0,7.602564102564102,0.24909210960712866
795,0,230,230,0,0,6.1173913043478265,0.2612682741598637
796,36,230,194,0,0,7.6,0.27598253275109486
797,1,236,235,0,0,6.834745762711864,0.29172376487558915
798,0,229,229,0,0,6.314410480349345,0.25158967287213446
799,0,244,244,0,0,6.491803278688525,0.27565270188220714
800,67,243,176,0,0,7.7407407407407405,0.27548209366390936
801,220,242,22,0,0,8.537190082644628,0.29944103425808244
802,0,227,227,0,0,6.577092511013216,0.31593310202331254
803,210,233,23,0,0,8.527896995708154,0.27615805830989837
804,9,239,230,0,0,7.334728033472803,0.2656376358074584
805,243,243,0,0,0,10.316872427983538,0.3000034010135043
806,2,243,241,0,0,6.991769547325103,0.23960140121756215
807,0,242,242,0,0,6.086776859504132,0.27874558485648726
808,235,235,0,0,0,10.748936170212765,0.2572104018912579
809,105,244,139,0,0,7.905737704918033,0.3161809350333938
810,240,240,0,0,0,10.870833333333334,0.2635808926080933
811,37,244,207,0,0,7.557377049180328,0.28064494366862097
812,0,240,240,0,0,6.158333333333333,0.2928172942817304
813,0,227,227,0,0,6.960352422907489,0.28603173365560497
814,0,233,233,0,0,6.394849785407725,0.29169749889004004
815,0,244,244,0,0,7.090163934426229,0.3045942116980398
816,0,230,230,0,0,5.969565217391304,0.26544522498575907
817,198,231,33,0,0,8.432900432900434,0.2639563335215549
818,16,239,223,0,0,7.456066945606694,0.2659189198692034
819,0,228,228,0,0,7.017543859649122,0.26400803771543047
820,0,241,241,0,0,6.560165975103734,0.29740663900414954
821,97,229,132,0,0,7.860262008733624,0.28740519420822846
822,3,228,225,0,0,7.1535087719298245,0.3067277223896745
823,1,241,240,0,0,7.04149377593361,0.3232710926694305
824,0,229,229,0,0,6.2314410480349345,0.2663755458515321
825,56,234,178,0,0,7.747863247863248,0.2666263159825392
826,43,230,187,0,0,7.660869565217391,0.32116954623125227
827,234,234,0,0,0,10.316239316239317,0.3201643373317132
828,0,230,230,0,0,6.2956521739130435,0.2702866907157765
829,236,236,0,0,0,9.957627118644067,0.33862243058059943
830,232,232,0,0,0,10.461206896551724,0.30151888341542754
831,0,240,240,0,0,6.545833333333333,0.29077754532775096
832,123,231,108,0,0,8.017316017316018,0.29535102578581207
833,0,238,238,0,0,6.197478991596639,0.2519767400631108
834,4,233,229,0,0,7.223175965665236,0.29480538700606523
835,0,239,239,0,0,6.03347280334728,0.20895889736648085
836,135,244,109,0,0,8.061475409836065,0.28838629157390444
837,0,243,243,0,0,6.337448559670782,0.3071455293677502
838,242,242,0,0,0,10.59504132231405,0.25856452110696015
839,200,244,44,0,0,8.405737704918034,0.29972002968359956
840,0,242,242,0,0,6.078512396694215,0.27181852474194673
841,198,242,44,0,0,8.396694214876034,0.27351599739378035
842,0,237,237,0,0,6.60337552742616,0.2657512693985524
843,57,232,175,0,0,7.754310344827586,0.27270861322585327
844,11,241,230,0,0,7.3029045643153525,0.31203319502074767
845,242,244,2,0,0,9.05327868852459,0.2893307697497086
846,91,237,146,0,0,7.818565400843882,0.2847386111707083
847,67,241,174,0,0,7.7053941908713695,0.25034578146611086
848,1,234,233,0,0,7.119658119658119,0.26888228604966646
849,17,229,212,0,0,7.384279475982533,0.272734237340078
850,2,239,237,0,0,6.928870292887029,0.25962518898772596
851,0,244,244,0,0,6.815573770491803,0.290949875193954
852,0,233,233,0,0,6.463519313304721,0.2928444575995227
853,232,232,0,0,0,9.668103448275861,0.28330721003135395
854,0,244,244,0,0,6.516393442622951,0.28368076637658013
855,43,243,200,0,0,7.613168724279835,0.2877597524062171
856,12,234,222,0,0,7.405982905982906,0.2679468838267086
857,4,232,228,0,0,7.107758620689655,0.2783811016569656
858,21,239,218,0,0,7.439330543933054,0.25575753313878063
859,0,234,234,0,0,6.358974358974359,0.29118520964014705
860,0,228,228,0,0,6.201754385964913,0.2939176134168039
861,8,239,231,0,0,7.2761506276150625,0.2847649520059089
862,5,236,231,0,0,7.038135593220339,0.2836458708979409
863,4,232,228,0,0,7.254310344827586,0.24240558292282294
864,20,231,211,0,0,7.428571428571429,0.2807453416149102
865,140,237,97,0,0,8.113924050632912,0.27933919759708276
866,228,228,0,0,0,9.258771929824562,0.30719143674163496
867,72,245,173,0,0,7.775510204081633,0.32234861157577727
868,0,237,237,0,0,6.848101265822785,0.26496459987127585
869,240,240,0,0,0,9.375,0.252092050209205
870,0,240,240,0,0,6.65,0.24518828451882999
871,235,235,0,0,0,9.2,0.3059829059828998
872,0,243,243,0,0,6.032921810699588,0.26337448559670446
873,0,244,244,0,0,6.389344262295082,0.28811644066653397
874,0,232,232,0,0,6.008620689655173,0.2683236303925984
875,0,235,235,0,0,6.506382978723404,0.2681214766321124
876,3,228,225,0,0,7.078947368421052,0.2932993276141926
877,6,233,227,0,0,7.347639484978541,0.31397069705490294
878,0,241,241,0,0,6.601659751037344,0.257330567081605
879,207,237,30,0,0,8.459915611814345,0.27486948437388614
880,236,237,1,0,0,8.886075949367088,0.22001716369877766
881,243,243,0,0,0,9.419753086419753,0.32721150902969476
882,0,232,232,0,0,6.392241379310345,0.30002612330198725
883,238,243,5,0,0,8.814814814814815,0.25895316804408214
884,0,233,233,0,0,6.515021459227468,0.29395441764096364
885,245,246,1,0,0,8.845528455284553,0.27808196449311384
886,93,233,140,0,0,7.927038626609442,0.23172265798431343
887,5,233,228,0,0,7.171673819742489,0.2721252034926724
888,245,245,0,0,0,10.889795918367346,0.31977249916360695
889,0,239,239,0,0,6.079497907949791,0.21634260398720373
890,11,239,228,0,0,7.317991631799163,0.3186245209380861
891,0,230,230,0,0,6.591304347826087,0.2776533130814467
892,0,243,243,0,0,6.08641975308642,0.2941536577900178
893,42,235,193,0,0,7.621276595744681,0.27903255137297467
894,16,240,224,0,0,7.391666666666667,0.28110181311017773
895,85,235,150,0,0,7.846808510638298,0.32685942898709064
896,193,243,50,0,0,8.40329218106996,0.2994932489882032
897,0,242,242,0,0,6.086776859504132,0.2455505641095993
898,0,226,226,0,0,6.911504424778761,0.24991150442477697
899,38,230,192,0,0,7.591304347826087,0.30385418644389206
900,0,230,230,0,0,6.256521739130434,0.3138219100056992
901,113,239,126,0,0,7.945606694560669,0.2869449034844075
902,0,232,232,0,0,6.689655172413793,0.2928795342588462
903,7,242,235,0,0,7.3264462809917354,0.2622852439902645
904,233,233,0,0,0,9.59656652360515,0.27619505697795577
905,0,240,240,0,0,5.933333333333334,0.28005578800557523
906,102,231,129,0,0,7.935064935064935,0.2001129305477108
907,239,240,1,0,0,9.183333333333334,0.27587168758717284
908,217,232,15,0,0,8.538793103448276,0.3101768920734362
909,2,228,226,0,0,7.140350877192983,0.27977432568204597
910,236,236,0,0,0,10.779661016949152,0.2235845654525737
911,227,239,12,0,0,8.635983263598327,0.26609472240779114
912,1,230,229,0,0,7.1521739130434785,0.23438389975317914
913,0,243,243,0,0,6.382716049382716,0.2702785430058138
914,244,244,0,0,0,10.475409836065573,0.27511300006746614
915,8,235,227,0,0,7.302127659574468,0.3143116930350982
916,93,233,140,0,0,7.858369098712446,0.32037146662720134
917,0,233,233,0,0,6.141630901287554,0.23416457007547722
918,0,233,233,0,0,6.763948497854077,0.31903951457747853
919,77,239,162,0,0,7.7782426778242675,0.2405330332970022
920,76,240,164,0,0,7.754166666666666,0.3200662482566213
921,0,233,233,0,0,6.643776824034335,0.2475580879088362
922,58,233,175,0,0,7.613733905579399,0.3070519461299415
923,0,228,228,0,0,5.982456140350878,0.32568204652600713
924,212,242,30,0,0,8.47107438016529,0.27509344672678604
925,110,241,131,0,0,7.987551867219917,0.2623443983402467
926,0,238,238,0,0,6.2899159663865545,0.30799914902669684
927,34,230,196,0,0,7.582608695652174,0.2966394531991666
928,51,242,191,0,0,7.615702479338843,0.2624909982510887
929,192,230,38,0,0,8.395652173913044,0.27509018416555975
930,6,242,236,0,0,7.25206611570248,0.2971948835773793
931,243,243,0,0,0,10.674897119341564,0.26990443152058746
932,0,227,227,0,0,6.41409691629956,0.2967915480877929
933,0,228,228,0,0,6.592105263157895,0.2778228611175554
934,21,242,221,0,0,7.400826446280992,0.26605740543877104
935,235,235,0,0,0,9.736170212765957,0.24633569739953057
936,84,241,157,0,0,7.825726141078838,0.26950207468880005
937,0,234,234,0,0,6.7094017094017095,0.24995414694985577
938,0,238,238,0,0,6.411764705882353,0.28543062794738283
939,241,241,0,0,0,10.929460580912863,0.2658367911479976
940,61,241,180,0,0,7.70954356846473,0.2819502074688823
941,237,237,0,0,0,9.518987341772151,0.2930701566187578
942,0,228,228,0,0,5.934210526315789,0.28199629028518347
943,206,233,27,0,0,8.459227467811159,0.24940802131123777
944,141,240,99,0,0,8.125,0.2604602510460251
945,16,239,223,0,0,7.430962343096234,0.32189444815583007
946,117,234,117,0,0,7.9914529914529915,0.23168629177212974
947,237,237,0,0,0,9.89451476793249,0.3150969033826864
948,32,241,209,0,0,7.5020746887966805,0.31770401106500684
949,5,245,240,0,0,7.2122448979591836,0.25804616928738394
950,52,246,194,0,0,7.695121951219512,0.2699352911896442
951,106,232,126,0,0,8.038793103448276,0.21926780116435315
952,0,233,233,0,0,6.261802575107296,0.2803019091312731
953,78,231,153,0,0,7.787878787878788,0.2722002635046089
954,0,243,243,0,0,6.580246913580247,0.26936026936026575
955,2,232,230,0,0,7.043103448275862,0.27519032691446293
956,245,245,0,0,0,9.253061224489796,0.2799598527935814
957,217,239,22,0,0,8.510460251046025,0.2845539889596021
958,145,233,88,0,0,8.223175965665236,0.24308124907503073
959,153,240,87,0,0,8.116666666666667,0.26248256624825766
960,0,239,239,0,0,6.707112970711297,0.23318448718399842
961,0,231,231,0,0,7.021645021645021,0.2734424995294593
962,102,231,129,0,0,7.965367965367966,0.2770562770562759
963,0,231,231,0,0,6.29004329004329,0.28507434594390835
964,0,237,237,0,0,6.274261603375527,0.250733032968606
965,0,237,237,0,0,6.413502109704641,0.2943931917328173
966,0,237,237,0,0,6.751054852320675,0.31488235714796553
967,62,245,183,0,0,7.718367346938775,0.27691535630645403
968,0,227,227,0,0,6.541850220264317,0.30244434914817825
969,1,226,225,0,0,6.889380530973451,0.2943756145526034
970,5,228,223,0,0,7.197368421052632,0.28246000463714394
971,62,231,169,0,0,7.70995670995671,0.26768304159608225
972,237,237,0,0,0,9.713080168776372,0.2647858113423508
973,0,232,232,0,0,5.982758620689655,0.2854157336915977
974,42,244,202,0,0,7.557377049180328,0.26418403831882675
975,19,226,207,0,0,7.402654867256637,0.3038151425762044
976,10,229,219,0,0,7.336244541484716,0.2592507469547248
977,61,235,174,0,0,7.719148936170213,0.27975995635569834
978,231,231,0,0,0,9.735930735930737,0.2908338038772775
979,239,239,0,0,0,10.380753138075313,0.27038430434935007
980,3,242,239,0,0,7.028925619834711,0.26886938033675206
981,0,235,235,0,0,6.004255319148936,0.28630660120021884
982,0,238,238,0,0,6.466386554621849,0.27523667694925735
983,247,247,0,0,0,10.194331983805668,0.27102465356637834
984,39,245,206,0,0,7.559183673469388,0.28029441284710715
985,103,243,140,0,0,7.94238683127572,0.28592320511512104
986,77,240,163,0,0,7.791666666666667,0.3162482566248282
987,0,237,237,0,0,6.265822784810126,0.2807337481227185
988,0,235,235,0,0,5.957446808510638,0.28877977814147765
989,0,230,230,0,0,6.721739130434782,0.2715777482437785
990,35,230,195,0,0,7.591304347826087,0.28638693753559513
991,0,229,229,0,0,6.327510917030568,0.2738450930820491
992,0,229,229,0,0,6.8034934497816595,0.298935110702523
993,236,240,4,0,0,8.841666666666667,0.2677126917712702
994,117,231,114,0,0,7.987012987012987,0.27374364765669074
995,237,237,0,0,0,9.966244725738397,0.2785167703640104
996,21,228,207,0,0,7.381578947368421,0.28106886158126254
997,50,246,196,0,0,7.691056910569106,0.2551850008295982
998,170,228,58,0,0,8.293859649122806,0.26128371589766974
999,88,245,157,0,0,7.840816326530613,0.3147206423553024
1000,0,242,242,0,0,6.268595041322314,0.2802544494358899
1001,0,226,226,0,0,6.3097345132743365,0.2414159292035361
1002,0,239,239,0,0,6.7907949790794975,0.35100734854611554
1003,0,228,228,0,0,6.008771929824562,0.281861040265864
1004,235,235,0,0,0,9.063829787234043,0.29932715039097424
1005,205,240,35,0,0,8.479166666666666,0.25897838214783314
1006,0,234,234,0,0,6.722222222222222,0.26156413924654615
1007,35,232,197,0,0,7.581896551724138,0.2876362143603504
1008,0,232,232,0,0,6.706896551724138,0.2600388117629478
1009,0,239,239,0,0,6.2594142259414225,0.24334587391442117
1010,160,239,79,0,0,8.171548117154812,0.2519601983052658
1011,138,232,94,0,0,8.137931034482758,0.27526496492014085
1012,0,234,234,0,0,6.068376068376068,0.27856645024026805
1013,61,244,183,0,0,7.676229508196721,0.2774573298252725
1014,22,235,213,0,0,7.472340425531915,0.2673940716493887
1015,0,236,236,0,0,6.3940677966101696,0.30787955283087015
1016,240,243,3,0,0,8.901234567901234,0.26293235384145197
1017,8,232,224,0,0,7.3405172413793105,0.2774854455888936
1018,0,237,237,0,0,6.675105485232067,0.28806407780877047
1019,108,242,134,0,0,7.987603305785124,0.2944514934330088
1020,245,245,0,0,0,10.040816326530612,0.2606222816995617
1021,240,240,0,0,0,9.566666666666666,0.29679218967922305
1022,230,230,0,0,0,9.273913043478261,0.260888551357506
1023,0,228,228,0,0,6.1535087719298245,0.2802960043280005
1024,207,229,22,0,0,8.550218340611353,0.29242319773231684
1025,116,245,129,0,0,7.979591836734694,0.27417196386751713
1026,18,229,211,0,0,7.362445414847161,0.27595188845476004
1027,1,239,238,0,0,6.887029288702929,0.31071340670159237
1028,0,243,243,0,0,6.674897119341564,0.26163996871067763
1029,0,230,230,0,0,6.547826086956522,0.29246250237327126
1030,0,231,231,0,0,6.54978354978355,0.3007716920760409
1031,0,237,237,0,0,6.725738396624473,0.2931059143245382
1032,76,244,168,0,0,7.795081967213115,0.2788234500438515
1033,86,230,144,0,0,7.9,0.2650655021834093
1034,0,243,243,0,0,6.2139917695473255,0.2763323470394162
1035,0,239,239,0,0,6.205020920502092,0.2561091382159561
1036,13,226,213,0,0,7.367256637168142,0.29563421828908354
1037,77,235,158,0,0,7.8382978723404255,0.289979996362972
1038,244,244,0,0,0,10.295081967213115,0.28293867638130005
1039,3,241,238,0,0,7.04149377593361,0.29827109266943047
1040,224,230,6,0,0,8.734782608695653,0.23066261629010987
1041,119,245,126,0,0,8.008163265306122,0.30321177651388204
1042,0,233,233,0,0,6.575107296137339,0.254032854817226
1043,17,232,215,0,0,7.392241379310345,0.2913681146439786
1044,0,243,243,0,0,6.588477366255144,0.26796585382443716
1045,19,228,209,0,0,7.434210526315789,0.2467539995362848
1046,235,235,0,0,0,10.685106382978724,0.259392616839421
1047,5,237,232,0,0,7.215189873417722,0.26281913752413627
1048,0,229,229,0,0,7.0873362445414845,0.2993564697770588
1049,20,235,215,0,0,7.476595744680851,0.29325331878523225
1050,32,230,198,0,0,7.595652173913043,0.2943041579646848
1051,238,238,0,0,0,9.491596638655462,0.26786157500975627
1052,0,239,239,0,0,6.158995815899582,0.2939418445202358
1053,240,240,0,0,0,9.5875,0.2851987447698684
1054,36,235,199,0,0,7.659574468085107,0.2682305873795252
1055,0,235,235,0,0,6.114893617021276,0.2987088561556634
1056,232,243,11,0,0,8.674897119341564,0.26990443152058746
1057,10,232,222,0,0,7.219827586206897,0.27614196148678555
1058,235,235,0,0,0,10.685106382978724,0.2850336424804466
1059,2,230,228,0,0,6.982608695652174,0.2791722042908697
1060,242,242,0,0,0,10.231404958677686,0.2532834950790434
1061,43,237,194,0,0,7.69620253164557,0.2801973825359355
1062,47,230,183,0,0,7.613043478260869,0.28192519460793547
1063,0,237,237,0,0,6.493670886075949,0.2849173996996334
1064,0,226,226,0,0,6.092920353982301,0.2624385447394323
1065,8,238,230,0,0,7.256302521008403,0.2589263553522658
1066,55,233,178,0,0,7.682403433476395,0.2780079917122999
1067,122,231,109,0,0,8.004329004329005,0.2825898738942234
1068,0,241,241,0,0,6.568464730290456,0.27966804979253085
1069,237,237,0,0,0,10.367088607594937,0.25874275906458566
1070,88,238,150,0,0,7.852941176470588,0.3200546041201277
1071,0,229,229,0,0,7.096069868995633,0.3152915038688406
1072,101,235,134,0,0,7.965957446808511,0.3065284597199483
1073,0,242,242,0,0,6.309917355371901,0.2396522752992024
1074,0,237,237,0,0,6.122362869198312,0.26038761353071493
1075,213,234,21,0,0,8.58974358974359,0.303070320237695
1076,93,230,137,0,0,7.856521739130435,0.28063413707993345
1077,51,238,187,0,0,7.701680672268908,0.2777186824096748
1078,0,240,240,0,0,6.508333333333334,0.27608089260809027
1079,0,236,236,0,0,6.228813559322034,0.2538045438153588
1080,2,227,225,0,0,7.061674008810573,0.2616662118435968
1081,50,228,178,0,0,7.7105263157894735,0.2770693252956166
1082,243,243,0,0,0,10.497942386831276,0.2758221950141076
1083,232,232,0,0,0,9.543103448275861,0.2751903269144708
1084,28,236,208,0,0,7.508474576271187,0.2509917057338595
1085,143,231,88,0,0,8.121212121212121,0.29828722002634805
1086,5,234,229,0,0,7.085470085470085,0.32742746047466825
1087,221,233,12,0,0,8.65236051502146,0.24500517981353148
1088,243,243,0,0,0,10.469135802469136,0.2748699112335465
1089,3,242,239,0,0,7.115702479338843,0.33510510613490607
1090,0,227,227,0,0,6.488986784140969,0.25983392460333143
1091,1,244,243,0,0,6.737704918032787,0.2765971800580188
1092,238,238,0,0,0,9.289915966386555,0.2573662376342918
1093,38,231,193,0,0,7.567099567099567,0.28134763786937306
1094,6,243,237,0,0,7.242798353909465,0.28378056660884726
1095,0,241,241,0,0,7.062240663900415,0.2836099585062205
1096,235,235,0,0,0,10.174468085106383,0.2899436261138448
1097,2,231,229,0,0,6.83982683982684,0.2742330133634507
1098,12,228,216,0,0,7.280701754385965,0.27328232475461556
1099,0,229,229,0,0,6.471615720524017,0.294146939400905
1100,15,232,217,0,0,7.396551724137931,0.30959844752947957
1101,180,231,51,0,0,8.311688311688311,0.2676453980801813
1102,239,239,0,0,0,9.259414225941423,0.28536268063711023
1103,0,236,236,0,0,6.758474576271187,0.2860980887125829
1104,0,228,228,0,0,6.0964912280701755,0.2902078986011282
1105,68,238,170,0,0,7.785714285714286,0.27034358047016604
1106,0,229,229,0,0,6.449781659388647,0.2836512679077634
1107,237,237,0,0,0,10.603375527426161,0.2996495744833059
1108,0,230,230,0,0,6.834782608695652,0.2607936206569205
1109,0,230,230,0,0,6.28695652173913,0.2666413518131756
1110,12,228,216,0,0,7.31140350877193,0.2858605765515099
1111,242,244,2,0,0,8.90983606557377,0.29636375902314266
1112,244,245,1,0,0,9.412244897959184,0.25968551354967756
1113,0,232,232,0,0,6.008620689655173,0.2683236303925984
1114,88,231,143,0,0,7.891774891774892,0.28823640127988176
1115,4,230,226,0,0,6.969565217391304,0.27417884943990756
1116,246,246,0,0,0,10.829268292682928,0.2809357889497306
1117,246,246,0,0,0,9.829268292682928,0.24011946241911833
1118,235,235,0,0,0,10.238297872340425,0.31903982542280573
1119,33,235,202,0,0,7.621276595744681,0.29612656846699176
1120,0,235,235,0,0,6.280851063829787,0.3395890161847582
1121,238,243,5,0,0,8.736625514403292,0.27745468149508024
1122,0,241,241,0,0,6.477178423236515,0.3088520055325034
1123,0,242,242,0,0,6.553719008264463,0.24813963855834786
1124,0,232,232,0,0,6.7155172413793105,0.2563815494849975
1125,247,247,0,0,0,9.785425101214575,0.24238833481452948
1126,3,242,239,0,0,7.107438016528926,0.27056685298857813
1127,0,234,234,0,0,6.004273504273504,0.25320054290011396
1128,0,237,237,0,0,6.751054852320675,0.3064077808767791
1129,0,242,242,0,0,6.7809917355371905,0.29623469702685373
1130,64,240,176,0,0,7.708333333333333,0.2827754532775479
1131,0,244,244,0,0,6.573770491803279,0.2867165890845318
1132,3,237,234,0,0,6.9113924050632916,0.2760137309590206
1133,0,227,227,0,0,6.334801762114537,0.27679232778449564
1134,8,243,235,0,0,7.189300411522634,0.28633132673536793
1135,223,230,7,0,0,8.817391304347826,0.2721853047275493
1136,92,243,151,0,0,7.851851851851852,0.27548209366390936
1137,13,242,229,0,0,7.322314049586777,0.2774253283495081
1138,232,232,0,0,0,10.34051724137931,0.2688274369308928
1139,245,245,0,0,0,10.791836734693877,0.2884576781532248
1140,95,230,135,0,0,7.956521739130435,0.2775773685209783
1141,94,241,147,0,0,7.908713692946058,0.21663208852005483
1142,25,244,219,0,0,7.508196721311475,0.26742224920731
1143,113,230,117,0,0,7.982608695652174,0.2529713309284243
1144,168,235,67,0,0,8.229787234042552,0.2461174759047127
1145,242,242,0,0,0,10.822314049586776,0.27950001714618106
1146,0,229,229,0,0,6.122270742358078,0.24814218953497402
1147,0,229,229,0,0,6.506550218340611,0.27736918716004366
1148,0,238,238,0,0,6.109243697478991,0.32556820196433106
1149,246,246,0,0,0,10.483739837398375,0.2752447320391574
1150,0,241,241,0,0,6.809128630705394,0.28841632088519875
1151,0,237,237,0,0,6.991561181434599,0.25416577272402474
1152,75,241,166,0,0,7.784232365145228,0.2615836791148013
1153,0,240,240,0,0,6.225,0.2587866108786626
1154,0,227,227,0,0,6.255506607929515,0.2795602510623373
1155,0,226,226,0,0,6.097345132743363,0.23048180924287104
1156,233,233,0,0,0,10.257510729613735,0.29547136303092664
1157,62,232,170,0,0,7.775862068965517,0.30452306314375116
1158,0,232,232,0,0,6.176724137931035,0.2673346768174368
1159,104,235,131,0,0,7.9361702127659575,0.2822331332969649
1160,5,230,225,0,0,7.21304347826087,0.25572432124549005
1161,0,242,242,0,0,6.4958677685950414,0.2510201982099395
1162,244,244,0,0,0,9.73360655737705,0.28676718612966656
1163,52,234,182,0,0,7.6752136752136755,0.3146619713143355
1164,8,242,234,0,0,7.202479338842975,0.3032303418949973
1165,236,236,0,0,0,10.385593220338983,0.2804724125495921
1166,0,228,228,0,0,6.368421052631579,0.26895432413632864
1167,123,241,118,0,0,8.004149377593361,0.23748271092669407
1168,241,241,0,0,0,9.136929460580912,0.31867219917012335
1169,3,244,241,0,0,6.991803278688525,0.2715374755447586
1170,0,228,228,0,0,6.18859649122807,0.2858605765515099
1171,0,237,237,0,0,6.0042194092827,0.2245583923335505
1172,115,233,118,0,0,8.025751072961373,0.24071333431996617
1173,116,230,114,0,0,8.030434782608696,0.25671160053161063
1174,104,235,131,0,0,7.948936170212766,0.2965266412074925
1175,241,241,0,0,0,9.410788381742739,0.2763831258644586
1176,116,243,127,0,0,8.016460905349794,0.29724858007686017
1177,0,244,244,0,0,6.799180327868853,0.3092997368953641
1178,232,232,0,0,0,10.806034482758621,0.3301798775936696
1179,160,239,79,0,0,8.146443514644352,0.2851868780985225
1180,0,244,244,0,0,6.327868852459017,0.28712136544559497
1181,122,228,106,0,0,8.017543859649123,0.2728186104026551
1182,73,243,170,0,0,7.806584362139918,0.23929531000237697
1183,83,236,153,0,0,7.758474576271187,0.2690768121168382
1184,0,231,231,0,0,6.627705627705628,0.2781855825334076
1185,247,247,0,0,0,10.894736842105264,0.3059477963200677
1186,16,244,228,0,0,7.381147540983607,0.26976657896512385
1187,0,231,231,0,0,6.813852813852814,0.24780726519857127
1188,76,235,159,0,0,7.748936170212766,0.3170394617203099
1189,11,230,219,0,0,7.343478260869565,0.2614201632808084
1190,48,229,181,0,0,7.668122270742358,0.3016547920018351
1191,3,240,237,0,0,7.104166666666667,0.26943863319386585
1192,1,235,234,0,0,6.731914893617021,0.23124204400800152
1193,235,235,0,0,0,10.472340425531915,0.30158210583742295
1194,3,241,238,0,0,6.908713692946058,0.2832987551867215
1195,6,234,228,0,0,7.243589743589744,0.3052162429844839
1196,0,234,234,0,0,6.282051282051282,0.2806206668867607
1197,0,229,229,0,0,6.131004366812227,0.28100819734926946
1198,0,236,236,0,0,6.233050847457627,0.2816263974035308
1199,197,233,36,0,0,8.412017167381974,0.277785999704018
1200,27,235,208,0,0,7.476595744680851,0.2676122931442066
1201,1,238,237,0,0,6.873949579831932,0.3300358117930686
1202,242,242,0,0,0,9.830578512396695,0.24918555605089227
1203,0,242,242,0,0,6.06198347107438,0.2741504063646688
1204,242,242,0,0,0,9.611570247933884,0.2800315489866574
1205,27,235,208,0,0,7.548936170212766,0.2913984360792843
1206,11,235,224,0,0,7.31063829787234,0.2834333515184593
1207,27,239,212,0,0,7.527196652719665,0.29232446116521954
1208,57,240,183,0,0,7.645833333333333,0.2715306834030709
1209,0,236,236,0,0,6.0508474576271185,0.33782906599351026
1210,229,229,0,0,0,9.301310043668122,0.2553052938021944
1211,0,236,236,0,0,6.398305084745763,0.2747205192931823
1212,0,229,229,0,0,6.4803493449781655,0.2682525090017646
1213,224,232,8,0,0,8.650862068965518,0.26285639647708453
1214,0,236,236,0,0,6.686440677966102,0.27573025604038737
1215,220,246,26,0,0,8.5,0.2673469387755102
1216,237,237,0,0,0,9.49789029535865,0.2595294285918622
1217,0,236,236,0,0,6.453389830508475,0.274413992066354
1218,12,234,222,0,0,7.333333333333333,0.26609442060085836
1219,233,233,0,0,0,10.051502145922747,0.2387154062453819
1220,0,241,241,0,0,6.423236514522822,0.2701244813277981
1221,107,243,136,0,0,7.983539094650205,0.3550998197462817
1222,81,242,161,0,0,7.8264462809917354,0.2768080655670279
1223,20,236,216,0,0,7.538135593220339,0.27513523260006856
1224,235,235,0,0,0,10.71063829787234,0.27488634297145076
1225,0,227,227,0,0,6.3392070484581495,0.30478343924213114
1226,36,228,192,0,0,7.649122807017544,0.2816291830898798
1227,234,234,0,0,0,10.405982905982906,0.26794688382671644
1228,108,231,123,0,0,7.974025974025974,0.3297571993224151
1229,234,234,0,0,0,10.67094017094017,0.26464546421628515
1230,235,235,0,0,0,10.012765957446808,0.2605200945626531
1231,119,237,118,0,0,7.974683544303797,0.2874919545161994
1232,240,240,0,0,0,9.695833333333333,0.2627440725244083
1233,1,243,242,0,0,6.8806584362139915,0.3121450192157298
1234,0,229,229,0,0,6.4803493449781655,0.25948057917720324
1235,0,238,238,0,0,6.054621848739496,0.2965819239088043
1236,0,229,229,0,0,5.9825327510917035,0.2628514517735375
1237,71,232,161,0,0,7.775862068965517,0.2785490371697252
1238,22,228,206,0,0,7.464912280701754,0.24986474998068053
1239,231,231,0,0,0,9.506493506493506,0.3032185206098328
1240,1,242,241,0,0,6.909090909090909,0.27385892116182575
1241,5,241,236,0,0,7.066390041493776,0.2205739972337445
1242,115,230,115,0,0,8.008695652173913,0.24446554015568883
1243,0,241,241,0,0,6.4896265560165975,0.284266943291838
1244,223,241,18,0,0,8.535269709543568,0.2747925311203289
1245,0,243,243,0,0,6.102880658436214,0.2992891881780797
1246,0,232,232,0,0,6.508620689655173,0.31161367368264165
1247,244,244,0,0,0,9.651639344262295,0.24440059367199132
1248,0,234,234,0,0,6.478632478632479,0.2763655038333139
1249,243,243,0,0,0,8.901234567901234,0.2794612794612867
1250,2,242,240,0,0,7.099173553719008,0.2639827166420905
1251,228,230,2,0,0,9.11304347826087,0.27537497626733204
1252,0,238,238,0,0,6.550420168067227,0.29913484381094224
1253,0,239,239,0,0,6.171548117154812,0.243556836960728
1254,41,229,188,0,0,7.593886462882096,0.3124186010878762
1255,55,243,188,0,0,7.695473251028806,0.2539876883311231
1256,0,239,239,0,0,6.857740585774058,0.23177806687528893
1257,0,229,229,0,0,6.777292576419214,0.29667509384815977
1258,0,229,229,0,0,5.956331877729258,0.32264613498812633
1259,86,234,148,0,0,7.82051282051282,0.2509078903928713
1260,0,231,231,0,0,6.108225108225108,0.2969320534537948
1261,244,244,0,0,0,9.315573770491802,0.2909498751939615
1262,2,230,228,0,0,6.891304347826087,0.27197645718625335
1263,232,232,0,0,0,9.318965517241379,0.25279892521271724
1264,236,236,0,0,0,10.639830508474576,0.2739812477461299
1265,238,238,0,0,0,9.411764705882353,0.2769918093819743
1266,237,237,0,0,0,9.531645569620252,0.2670027891010589
1267,241,241,0,0,0,10.186721991701244,0.2774896265560225
1268,174,245,71,0,0,8.236734693877551,0.2961860153897656
1269,0,232,232,0,0,6.512931034482759,0.28554635020152613
1270,222,233,11,0,0,8.772532188841202,0.2540698534852677
1271,0,240,240,0,0,6.104166666666667,0.286175034867506
1272,19,234,215,0,0,7.431623931623932,0.2635449910128002
1273,146,229,83,0,0,8.148471615720524,0.2761051099364123
1274,0,234,234,0,0,6.243589743589744,0.288048861010235
1275,234,234,0,0,0,9.517094017094017,0.26794688382671644
1276,1,235,234,0,0,6.910638297872341,0.20992907801418267
1277,0,243,243,0,0,6.032921810699588,0.2716389484066218
1278,155,242,87,0,0,8.119834710743802,0.2884846198690013
1279,2,227,225,0,0,7.167400881057269,0.26388834743284756
1280,0,240,240,0,0,6.804166666666666,0.2669281729428183
1281,0,241,241,0,0,6.095435684647303,0.30335408022130345
1282,240,243,3,0,0,8.901234567901234,0.23813896541169993
1283,1,230,229,0,0,6.8,0.3004366812227042
1284,83,236,153,0,0,7.822033898305085,0.30010818608005796
1285,0,230,230,0,0,6.339130434782609,0.2687677995063615
1286,24,241,217,0,0,7.4979253112033195,0.2927040110650069
1287,7,230,223,0,0,7.191304347826087,0.2776533130814467
1288,0,242,242,0,0,6.132231404958677,0.2811974897980147
1289,0,236,236,0,0,6.029661016949152,0.30124413992066656
1290,235,236,1,0,0,8.911016949152541,0.26013342949874174
1291,0,245,245,0,0,6.612244897959184,0.279357644697223
1292,238,238,0,0,0,10.331932773109244,0.2564443498918484
1293,234,234,0,0,0,9.175213675213675,0.30822420307398435
1294,80,232,152,0,0,7.900862068965517,0.26285639647708453
1295,0,238,238,0,0,6.689075630252101,0.27422614615466717
1296,225,228,3,0,0,8.824561403508772,0.3038874719839257
1297,121,242,121,0,0,8.024793388429751,0.31473543431295553
1298,0,241,241,0,0,6.323651452282157,0.24481327800829908
1299,0,229,229,0,0,6.414847161572053,0.27890140197655855
1300,0,238,238,0,0,6.7899159663865545,0.25947594227564197
1301,37,243,206,0,0,7.604938271604938,0.28956228956229263
1302,0,242,242,0,0,6.243801652892562,0.28471245842049475
1303,21,230,209,0,0,7.395652173913043,0.31002468198215366
1304,236,236,0,0,0,10.09322033898305,0.2551027767760543
1305,131,236,105,0,0,8.063559322033898,0.25551749008294056
1306,235,236,1,0,0,9.021186440677965,0.25912369275152897
1307,11,241,230,0,0,7.331950207468879,0.2643499308437034
1308,39,241,202,0,0,7.568464730290456,0.27966804979253085
1309,75,235,160,0,0,7.817021276595745,0.2868885251863946
1310,0,242,242,0,0,5.983471074380165,0.27358458214739095
1311,5,231,226,0,0,7.025974025974026,0.2601919819311107
1312,0,243,243,0,0,6.773662551440329,0.24194810053395938
1313,247,247,0,0,0,10.1417004048583,0.2603271781705647
1314,104,234,130,0,0,7.914529914529915,0.2415905506034236
1315,246,246,0,0,0,10.674796747967479,0.3183009789281493
1316,38,237,199,0,0,7.60337552742616,0.2996495744832982
1317,67,231,164,0,0,7.7272727272727275,0.268774703557313
1318,6,234,228,0,0,7.230769230769231,0.27269725982172094
1319,233,233,0,0,0,9.605150214592275,0.29169749889004004
1320,216,241,25,0,0,8.547717842323651,0.29875518672198875
1321,50,241,191,0,0,7.655601659751038,0.2683955739972362
1322,0,242,242,0,0,6.24793388429752,0.3117177051541427
1323,29,239,210,0,0,7.489539748953975,0.29295735030413994
1324,166,238,72,0,0,8.205882352941176,0.24857284686026535
1325,145,230,85,0,0,8.126086956521739,0.2678754509208263
1326,0,238,238,0,0,6.487394957983193,0.27621175052299496
1327,0,237,237,0,0,5.9957805907173,0.28388042623185555
1328,0,232,232,0,0,6.228448275862069,0.3155508284818605
1329,86,238,152,0,0,7.785714285714286,0.2787823990355669
1330,116,238,122,0,0,7.970588235294118,0.2649540828989851
1331,29,238,209,0,0,7.5210084033613445,0.2674892741906891
1332,222,235,13,0,0,8.71063829787234,0.25779232587743367
1333,99,231,132,0,0,7.896103896103896,0.25872388481083874
1334,0,243,243,0,0,6.711934156378601,0.28857599564670344
1335,229,232,3,0,0,9.017241379310345,0.2854157336915898
1336,0,240,240,0,0,6.654166666666667,0.2773884239888434
1337,194,233,39,0,0,8.433476394849786,0.2811158798283251
1338,53,236,183,0,0,7.648305084745763,0.28855030652722485
1339,27,234,207,0,0,7.619658119658119,0.2881955907706965
1340,238,239,1,0,0,9.418410041841005,0.3031890580499932
1341,0,236,236,0,0,6.419491525423729,0.27008654886404326
1342,11,240,229,0,0,7.216666666666667,0.23737796373779738
1343,114,232,118,0,0,7.978448275862069,0.2203127332437653
1344,4,239,235,0,0,7.079497907949791,0.27516613339896845
1345,212,245,33,0,0,8.424489795918367,0.278086316493813
1346,141,229,88,0,0,8.14410480349345,0.2817743047575309
1347,113,238,125,0,0,7.899159663865547,0.30202460731127945
1348,0,236,236,0,0,6.809322033898305,0.2741254958528635
1349,7,240,233,0,0,7.2125,0.30193514644351616
1350,106,245,139,0,0,7.906122448979592,0.26574105051856695
1351,76,236,160,0,0,7.779661016949152,0.28315903353768784
1352,231,231,0,0,0,10.021645021645021,0.2386598908337992
1353,110,242,132,0,0,7.913223140495868,0.2455505641095993
1354,13,230,217,0,0,7.3304347826086955,0.28334915511676506
1355,246,246,0,0,0,10.451219512195122,0.2812842210054775
1356,0,235,235,0,0,6.617021276595745,0.2629569012547769
1357,0,241,241,0,0,6.518672199170124,0.267358229598896
1358,0,228,228,0,0,6.776315789473684,0.2625202875029003
1359,0,228,228,0,0,6.416666666666667,0.2705580029368549
1360,7,242,235,0,0,7.276859504132231,0.284026610884404
1361,107,235,128,0,0,8.0,0.3076923076923077
1362,0,242,242,0,0,6.4421487603305785,0.2808717122183776
1363,0,228,228,0,0,7.0131578947368425,0.33022258288894296
1364,18,232,214,0,0,7.392241379310345,0.2913681146439786
1365,232,232,0,0,0,10.870689655172415,0.26026272577997367
1366,0,230,230,0,0,6.730434782608696,0.3287640022783355
1367,94,235,141,0,0,7.842553191489362,0.26997635933806036
1368,0,236,236,0,0,6.110169491525424,0.27717273710782425
1369,34,246,212,0,0,7.508130081300813,0.2836071013771363
1370,246,246,0,0,0,10.0,0.2612244897959184
1371,0,228,228,0,0,6.2105263157894735,0.2990957570136783
1372,0,232,232,0,0,6.987068965517241,0.2639013285565045
1373,50,243,193,0,0,7.6419753086419755,0.2638506274869925
1374,0,238,238,0,0,6.2899159663865545,0.26580505619969264
1375,0,231,231,0,0,6.54978354978355,0.2746847355543018
1376,246,246,0,0,0,10.853658536585366,0.2560477849676503
1377,243,243,0,0,0,10.62962962962963,0.325068870523421
1378,0,233,233,0,0,6.23175965665236,0.2908835281929881
1379,0,231,231,0,0,6.194805194805195,0.23579898362507304
1380,1,232,231,0,0,6.853448275862069,0.2901179280489601
1381,0,235,235,0,0,6.3319148936170215,0.30816512093107845
1382,3,232,229,0,0,6.918103448275862,0.26599119271532873
1383,231,234,3,0,0,8.88034188034188,0.21738014012692752
1384,24,230,206,0,0,7.452173913043478,0.3186633757357167
1385,14,232,218,0,0,7.379310344827586,0.2797432452604853
1386,0,235,235,0,0,6.774468085106383,0.2352427714129854
1387,139,233,94,0,0,8.098712446351932,0.23590350747372996
1388,182,244,62,0,0,8.295081967213115,0.27470822370640297
1389,1,231,230,0,0,6.779220779220779,0.2510446075663466
1390,6,231,225,0,0,7.186147186147186,0.29128552606813646
1391,0,235,235,0,0,6.906382978723404,0.24760865611929497
1392,95,239,144,0,0,7.912133891213389,0.315776519812948
1393,237,237,0,0,0,10.38396624472574,0.27991132088964615
1394,0,240,240,0,0,6.254166666666666,0.2824093444909309
1395,245,245,0,0,0,10.126530612244897,0.3158916025426539
1396,0,230,230,0,0,6.747826086956522,0.3029428517182478
1397,0,238,238,0,0,6.084033613445378,0.2713895684856242
1398,33,245,212,0,0,7.481632653061224,0.3244563399130129
1399,0,236,236,0,0,6.228813559322034,0.28784709700684813
1400,0,235,235,0,0,6.1191489361702125,0.24215311874886383
1401,0,227,227,0,0,6.8061674008810575,0.28084675061401176
1402,16,232,216,0,0,7.426724137931035,0.28032168980444977
1403,0,228,228,0,0,6.337719298245614,0.27751371821624576
1404,33,236,203,0,0,7.567796610169491,0.2719798052650576
1405,238,239,1,0,0,8.97907949790795,0.2642663760064757
1406,116,238,122,0,0,8.046218487394958,0.2214835301209119
1407,0,228,228,0,0,6.171052631578948,0.28338743334106486
1408,238,238,0,0,0,10.184873949579831,0.26947487855901686
1409,0,229,229,0,0,6.08296943231441,0.2869455297632716
1410,0,228,228,0,0,6.421052631578948,0.31532575933225426
1411,0,226,226,0,0,6.252212389380531,0.27832841691248983
1412,4,239,235,0,0,7.2761506276150625,0.2595548679722955
1413,0,231,231,0,0,6.523809523809524,0.28530020703933784
1414,246,246,0,0,0,9.560975609756097,0.2881035340965633
1415,232,232,0,0,0,10.551724137931034,0.27436930885206096
1416,237,237,0,0,0,10.388185654008439,0.2554530501322962
1417,197,235,38,0,0,8.382978723404255,0.3313329696308453
1418,1,242,241,0,0,6.681818181818182,0.27593360995850624
1419,209,240,31,0,0,8.529166666666667,0.29203277545327855
1420,22,231,209,0,0,7.515151515151516,0.2943346508563912
1421,0,226,226,0,0,6.115044247787611,0.23559488692231956
1422,0,229,229,0,0,6.034934497816594,0.2707040527081932
1423,62,237,175,0,0,7.7215189873417724,0.2950010727311765
1424,119,237,118,0,0,7.953586497890296,0.3071586926982753
1425,0,227,227,0,0,6.1938325991189425,0.26314763556976395
1426,0,237,237,0,0,6.670886075949367,0.29800472001716116
1427,212,230,18,0,0,8.504347826086956,0.2860072147332374
1428,229,232,3,0,0,9.056034482758621,0.2868898343036263
1429,2,232,230,0,0,6.969827586206897,0.24583893118375524
1430,69,240,171,0,0,7.745833333333334,0.2322001394700104
1431,0,229,229,0,0,6.554585152838428,0.29196353328736796
1432,0,231,231,0,0,6.458874458874459,0.3102578580839453
1433,44,245,201,0,0,7.563265306122449,0.28798929407829016
1434,24,242,218,0,0,7.471074380165289,0.2584959363533496
1435,240,240,0,0,0,10.158333333333333,0.34302649930265094
1436,0,233,233,0,0,6.875536480686695,0.28185585318928574
1437,0,243,243,0,0,6.012345679012346,0.24364860728497315
1438,0,240,240,0,0,6.2,0.32803347280334577
1439,0,242,242,0,0,6.946280991735537,0.26681183772847233
1440,0,238,238,0,0,6.315126050420168,0.2673651739176667
1441,0,242,242,0,0,5.975206611570248,0.2898391687527896
1442,193,239,46,0,0,8.364016736401673,0.28290144509686677
1443,18,239,221,0,0,7.389121338912134,0.25551140958475477
1444,0,234,234,0,0,6.410256410256411,0.268735556289205
1445,0,231,231,0,0,6.787878787878788,0.23741765480895677
1446,53,232,179,0,0,7.663793103448276,0.2934020002985523
1447,231,231,0,0,0,10.891774891774892,0.2708450969320478
1448,232,232,0,0,0,9.323275862068966,0.27166368114643324
1449,2,240,238,0,0,7.1125,0.3094665271966512
1450,227,236,9,0,0,8.80084745762712,0.21123332131265146
1451,122,245,123,0,0,8.004081632653062,0.2909668785547019
1452,240,240,0,0,0,10.1875,0.236663179916318
1453,0,238,238,0,0,6.331932773109243,0.29863844271886025
1454,0,240,240,0,0,6.2625,0.23624476987447546
1455,0,243,243,0,0,6.106995884773663,0.22817399585076126
1456,19,241,222,0,0,7.406639004149378,0.28395573997233897
1457,3,235,232,0,0,6.885106382978724,0.30725586470267197
1458,11,236,225,0,0,7.313559322033898,0.2927515326361321
1459,1,228,227,0,0,6.706140350877193,0.3317682973954671
1460,0,235,235,0,0,6.438297872340425,0.26433897072194634
1461,33,234,201,0,0,7.572649572649572,0.28010711272513755
1462,120,228,108,0,0,8.0,0.32599118942731276
1463,6,231,225,0,0,7.121212121212121,0.24611330698286982
1464,16,232,216,0,0,7.413793103448276,0.27825048514703715
1465,9,239,230,0,0,7.2803347280334725,0.23620829084771655
1466,212,242,30,0,0,8.413223140495868,0.27667089605980677
1467,0,236,236,0,0,6.11864406779661,0.32628921745402273
1468,59,243,184,0,0,7.654320987654321,0.31802877257422935
1469,246,246,0,0,0,9.601626016260163,0.29779326364692604
1470,3,228,225,0,0,7.048245614035087,0.24876342839477744
1471,16,233,217,0,0,7.390557939914163,0.2821518425336668
1472,48,231,183,0,0,7.653679653679654,0.2795407491059687
1473,0,241,241,0,0,6.987551867219917,0.3040110650069134
1474,6,231,225,0,0,7.242424242424242,0.28880105401844364
1475,114,229,115,0,0,8.013100436681222,0.3024592047805096
1476,233,233,0,0,0,10.759656652360515,0.2954343643628849
1477,1,228,227,0,0,6.916666666666667,0.2705580029368549
1478,0,237,237,0,0,6.69198312236287,0.24794393191732678
1479,7,228,221,0,0,7.25,0.30286343612334804
1480,5,233,228,0,0,7.145922746781116,0.29758028710966755
1481,186,230,44,0,0,8.391304347826088,0.25669261439149355
1482,5,233,228,0,0,7.072961373390558,0.30068817522569274
1483,241,241,0,0,0,9.33195020746888,0.2726832641770367
1484,242,242,0,0,0,9.429752066115702,0.24608209595007566
1485,0,230,230,0,0,6.178260869565217,0.3217960888551322
1486,0,243,243,0,0,6.699588477366255,0.29367751589973723
1487,1,236,235,0,0,6.567796610169491,0.2975117201586746
1488,237,237,0,0,0,11.021097046413502,0.2919259100336156
1489,3,231,228,0,0,6.96969696969697,0.3164690382081655
1490,240,242,2,0,0,9.305785123966942,0.27955145571139084
1491,36,241,205,0,0,7.5850622406639,0.2521092669432922
1492,0,240,240,0,0,5.995833333333334,0.2552126917712656
1493,205,237,32,0,0,8.438818565400844,0.2896731745691271
1494,0,230,230,0,0,6.760869565217392,0.2613442187203321
1495,2,240,238,0,0,7.075,0.2705020920502077
1496,232,232,0,0,0,9.387931034482758,0.30773249738766545
1497,237,237,0,0,0,11.0084388185654,0.2965386540799492
1498,42,233,191,0,0,7.630901287553648,0.27697202900695816
1499,231,231,0,0,0,11.012987012987013,0.2650479954827777
1500,0,242,242,0,0,6.760330578512397,0.2908679400569257
1501,233,233,0,0,0,10.133047210300429,0.28825662276157626
1502,0,244,244,0,0,6.69672131147541,0.26978344464683546
1503,242,242,0,0,0,10.446280991735538,0.2730359041185138
1504,0,229,229,0,0,6.192139737991266,0.30502566459817737
1505,0,235,235,0,0,6.642553191489362,0.29048917985088557
1506,247,247,0,0,0,10.295546558704453,0.28221585859583737
1507,243,243,0,0,0,9.954732510288066,0.2748018909635053
1508,0,238,238,0,0,5.936974789915967,0.25339502889763615
1509,0,232,232,0,0,6.754310344827586,0.26405060456784457
1510,55,232,177,0,0,7.693965517241379,0.29121883863263065
1511,3,232,229,0,0,7.172413793103448,0.316465144051352
1512,37,230,193,0,0,7.573913043478261,0.298006455287637
1513,1,230,229,0,0,6.8652173913043475,0.30053161192329764
1514,0,238,238,0,0,6.995798319327731,0.2742438747650935
1515,3,243,240,0,0,7.176954732510288,0.22888820868618587
1516,6,233,227,0,0,7.171673819742489,0.2807458931478448
1517,38,232,194,0,0,7.577586206896552,0.27966860725481524
1518,70,231,161,0,0,7.809523809523809,0.26790890269151174
1519,0,229,229,0,0,7.0174672489082965,0.25407952194897615
1520,2,227,225,0,0,6.903083700440528,0.26490195314023063
1521,237,237,0,0,0,10.91139240506329,0.28448830723021473
1522,244,245,1,0,0,9.097959183673469,0.3264302442288323
1523,0,229,229,0,0,6.781659388646288,0.2942235501417312
1524,6,242,236,0,0,7.243801652892562,0.27641370323377273
1525,224,241,17,0,0,8.614107883817427,0.2546334716459266
1526,0,234,234,0,0,6.735042735042735,0.26426029859506583
1527,239,239,0,0,0,10.98326359832636,0.2770296403080106
1528,63,243,180,0,0,7.773662551440329,0.2584770261537941
1529,242,242,0,0,0,9.99586776859504,0.26139364219333444
1530,99,241,142,0,0,7.821576763485477,0.2721991701244785
1531,245,245,0,0,0,10.693877551020408,0.27885580461693055
1532,230,230,0,0,0,10.543478260869565,0.2666603379532927
1533,244,244,0,0,0,10.094262295081966,0.3079504823584967
1534,0,234,234,0,0,6.55982905982906,0.2732291552034018
1535,28,229,201,0,0,7.541484716157205,0.28445568068642996
1536,230,230,0,0,0,10.673913043478262,0.27311562559331065
1537,0,235,235,0,0,6.276595744680851,0.2607746863065982
1538,0,232,232,0,0,6.629310344827586,0.2602627257799658
1539,0,235,235,0,0,6.034042553191489,0.2723404255319141
1540,235,235,0,0,0,10.004255319148935,0.26921258410620175
1541,15,232,217,0,0,7.461206896551724,0.2668868487834008
1542,0,246,246,0,0,6.487804878048781,0.2998506719761095
1543,0,230,230,0,0,6.4,0.29344978165939184
1544,233,233,0,0,0,9.317596566523605,0.31249075033298956
1545,0,226,226,0,0,6.150442477876106,0.2794886922320519
1546,9,240,231,0,0,7.225,0.2922594142259429
1547,4,244,240,0,0,7.131147540983607,0.19672131147541191
1548,237,237,0,0,0,9.864978902953586,0.28677680040048364
1549,246,246,0,0,0,10.475609756097562,0.2667496266799334
1550,0,236,236,0,0,6.898305084745763,0.27046520014424613
1551,33,236,203,0,0,7.665254237288136,0.24917057338622745
1552,0,225,225,0,0,6.128888888888889,0.2556349206349182
1553,0,240,240,0,0,6.045833333333333,0.2614888423988807
1554,242,245,3,0,0,9.0,0.2540983606557377
1555,229,229,0,0,0,10.436681222707424,0.29970121811078443
1556,197,231,34,0,0,8.415584415584416,0.25262563523432935
1557,96,229,133,0,0,7.908296943231441,0.3205010342450023
1558,6,241,235,0,0,7.091286307053942,0.2666320885200548
1559,245,245,0,0,0,9.706122448979592,0.2575443292070915
1560,73,238,165,0,0,7.823529411764706,0.23033010672623255
1561,0,229,229,0,0,6.25764192139738,0.24473301156821867
1562,0,237,237,0,0,6.3164556962025316,0.2511263677322442
1563,224,231,7,0,0,8.753246753246753,0.273630717108972
1564,55,243,188,0,0,7.7366255144032925,0.2443968302554183
1565,13,233,220,0,0,7.339055793991417,0.2681663460115456
1566,237,237,0,0,0,10.79324894514768,0.2663949081026997
1567,237,237,0,0,0,10.345991561181435,0.278087677894584
1568,0,235,235,0,0,5.940425531914894,0.28703400618294245
1569,0,242,242,0,0,6.1115702479338845,0.25720997222317193
1570,137,242,105,0,0,8.099173553719009,0.33867151332258844
1571,12,241,229,0,0,7.3112033195020745,0.30691562932227046
1572,3,233,230,0,0,7.072961373390558,0.24896403729465827
1573,0,239,239,0,0,6.2887029288702925,0.29865335255440834
1574,134,237,103,0,0,8.033755274261603,0.2530930415504511
1575,110,238,128,0,0,7.987394957983193,0.2741020458816448
1576,242,242,0,0,0,10.409090909090908,0.2676348547717842
1577,131,240,109,0,0,7.991666666666666,0.24260808926080993
1578,0,243,243,0,0,6.131687242798354,0.3049008604564147
1579,27,232,205,0,0,7.564655172413793,0.2988319152112272
1580,0,245,245,0,0,6.914285714285715,0.27540983606557673
1581,231,231,0,0,0,9.311688311688311,0.2850367024280074
1582,230,230,0,0,0,10.747826086956522,0.31167647617238836
1583,0,241,241,0,0,5.979253112033195,0.3620677731673595
1584,72,241,169,0,0,7.767634854771784,0.29578146611341555
1585,60,241,181,0,0,7.7053941908713695,0.29201244813277755
1586,0,226,226,0,0,6.252212389380531,0.2961061946902676
1587,1,235,234,0,0,7.102127659574468,0.2972176759410811
1588,70,230,160,0,0,7.8130434782608695,0.2662046705904666
1589,38,239,201,0,0,7.631799163179917,0.27562321999929346
1590,0,227,227,0,0,6.008810572687224,0.24770964094967032
1591,235,236,1,0,0,9.110169491525424,0.3282365668950661
1592,219,230,11,0,0,8.68695652173913,0.31205619897474607
1593,235,235,0,0,0,10.004255319148935,0.2521185670121846
1594,0,230,230,0,0,6.852173913043479,0.26626162901082584
1595,0,228,228,0,0,7.048245614035087,0.2928162918309008
1596,0,231,231,0,0,6.2727272727272725,0.3035573122529652
1597,0,228,228,0,0,6.425438596491228,0.2719491459927363
1598,160,237,77,0,0,8.19831223628692,0.28677680040048364
1599,0,239,239,0,0,6.485355648535565,0.27604514609190706
1600,0,237,237,0,0,6.662447257383966,0.31777873131660134
1601,22,232,210,0,0,7.482758620689655,0.2940737423496063
1602,243,243,0,0,0,9.91358024691358,0.2776247321701906
1603,14,228,214,0,0,7.385964912280702,0.30852461550351423
1604,35,233,198,0,0,7.510729613733906,0.2682033446795952
1605,0,238,238,0,0,5.987394957983193,0.2994185015778473
1606,0,245,245,0,0,6.869387755102041,0.2615590498494459
1607,0,244,244,0,0,6.10655737704918,0.30135600080954905
1608,59,241,182,0,0,7.7012448132780085,0.2437067773167352
1609,229,230,1,0,0,8.943478260869565,0.28063413707993345
1610,237,237,0,0,0,10.90295358649789,0.21511835800615467
1611,234,234,0,0,0,10.717948717948717,0.29778804886101745
1612,3,228,225,0,0,7.135964912280702,0.2853968621995495
1613,233,233,0,0,0,9.034334763948499,0.30054018055349435
1614,19,232,213,0,0,7.422413793103448,0.27966860725481524
1615,39,229,190,0,0,7.524017467248909,0.2768329119742607
1616,0,232,232,0,0,6.642241379310345,0.28271010598596996
1617,0,241,241,0,0,6.190871369294606,0.25508298755186537
1618,0,233,233,0,0,6.446351931330472,0.26542844457599285
1619,162,232,70,0,0,8.25,0.2748917748917749
1620,0,234,234,0,0,6.777777777777778,0.30233667143538734
1621,14,242,228,0,0,7.351239669421488,0.2869071705359881
1622,0,244,244,0,0,6.770491803278689,0.25986642380084657
1623,9,239,230,0,0,7.292887029288703,0.29200801659576314
1624,0,237,237,0,0,6.156118143459915,0.2848458842880649
1625,36,233,197,0,0,7.626609442060086,0.2867026787035637
1626,0,237,237,0,0,6.556962025316456,0.28169920617892785
1627,245,245,0,0,0,10.612244897959183,0.2957510873201813
1628,0,242,242,0,0,6.2272727272727275,0.27593360995850624
1629,227,236,9,0,0,8.711864406779661,0.26556076451496996
1630,0,237,237,0,0,6.0,0.2796610169491525
1631,0,229,229,0,0,6.283842794759825,0.2918869225465418
1632,94,233,139,0,0,7.896995708154506,0.24796507325736614
1633,3,234,231,0,0,7.153846153846154,0.24232419940574687
1634,0,245,245,0,0,6.608163265306122,0.2802609568417494
1635,87,239,152,0,0,7.820083682008368,0.2994268837241974
1636,0,239,239,0,0,6.631799163179917,0.26721985865475567
1637,0,239,239,0,0,6.330543933054393,0.2810379381878246
1638,8,234,226,0,0,7.196581196581197,0.2702028538938437
1639,0,226,226,0,0,6.29646017699115,0.2539429695181914
1640,10,227,217,0,0,7.1629955947136565,0.2520759424583812
1641,73,231,158,0,0,7.813852813852814,0.2999811782420495
1642,1,238,237,0,0,6.764705882352941,0.2988334574336032
1643,0,232,232,0,0,6.538793103448276,0.2668868487834008
1644,40,242,202,0,0,7.681818181818182,0.2842323651452282
1645,29,241,212,0,0,7.576763485477178,0.2701244813277981
1646,245,245,0,0,0,9.269387755102041,0.24680495148879614
1647,0,243,243,0,0,6.444444444444445,0.2644628099173554
1648,213,241,28,0,0,8.535269709543568,0.2747925311203289
1649,3,237,234,0,0,7.0210970464135025,0.25802760494886984
1650,0,240,240,0,0,6.533333333333333,0.2834030683403079
1651,232,237,5,0,0,8.856540084388186,0.30984052063219786
1652,0,243,243,0,0,6.6419753086419755,0.2721150902969099
1653,242,242,0,0,0,10.950413223140496,0.23819484928500206
1654,79,246,167,0,0,7.780487804878049,0.2863115978098551
1655,5,231,226,0,0,7.242424242424242,0.2801054018445306
1656,0,235,235,0,0,6.446808510638298,0.28241498454264774
1657,0,233,233,0,0,6.742489270386266,0.3040920526861069
1658,12,242,230,0,0,7.3429752066115705,0.26777202427900537
1659,0,230,230,0,0,6.239130434782608,0.2700778431744806
1660,0,230,230,0,0,5.991304347826087,0.2881336624264312
1661,12,233,221,0,0,7.317596566523605,0.26938730205712746
1662,5,240,235,0,0,7.129166666666666,0.29705369595536607
1663,235,244,9,0,0,8.680327868852459,0.275990015516424
1664,235,235,0,0,0,10.778723404255318,0.24997272231314097
1665,15,228,213,0,0,7.421052631578948,0.30651518664502964
1666,240,243,3,0,0,9.127572016460906,0.27704655987484833
1667,14,232,218,0,0,7.366379310344827,0.27644051350948146
1668,12,238,226,0,0,7.38655462184874,0.2887636067085078
1669,0,229,229,0,0,6.716157205240175,0.274343062897419
1670,245,245,0,0,0,9.155102040816326,0.254533288725322
1671,0,239,239,0,0,6.937238493723849,0.26075032523469815
1672,232,232,0,0,0,9.336206896551724,0.28474399164053577
1673,0,235,235,0,0,6.0,0.2905982905982906
1674,0,242,242,0,0,6.297520661157025,0.28455814272487284
1675,0,227,227,0,0,6.41409691629956,0.27024287552142123
1676,240,244,4,0,0,8.709016393442623,0.26477433717871
1677,12,242,230,0,0,7.409090909090909,0.2676348547717842
1678,0,233,233,0,0,6.197424892703863,0.30568299541216126
1679,53,227,174,0,0,7.753303964757709,0.27515496471872297
1680,20,230,210,0,0,7.469565217391304,0.2850958800075931
1681,244,244,0,0,0,9.094262295081966,0.24210686095931974
1682,0,235,235,0,0,6.025531914893617,0.2728496090198199
1683,0,232,232,0,0,5.943965517241379,0.24359979101358303
1684,0,228,228,0,0,6.0964912280701755,0.22853388979055556
1685,0,231,231,0,0,6.896103896103896,0.24133258046301267
1686,244,244,0,0,0,10.819672131147541,0.2636443365040783
1687,235,235,0,0,0,9.0,0.23931623931623933
1688,16,228,212,0,0,7.4298245614035086,0.28139732591390354
1689,1,242,241,0,0,6.739669421487603,0.29294262885360617
1690,0,242,242,0,0,6.764462809917355,0.28039161894311104
1691,13,243,230,0,0,7.390946502057613,0.2969424888616825
1692,232,232,0,0,0,10.732758620689655,0.30056724884310493
1693,0,231,231,0,0,6.926406926406926,0.2684735554300736
1694,233,235,2,0,0,8.863829787234042,0.2548827059465391
1695,0,227,227,0,0,6.726872246696035,0.2790534482086498
1696,91,246,155,0,0,7.861788617886178,0.2665339306454315
1697,0,239,239,0,0,6.2803347280334725,0.26141837488133
1698,77,231,154,0,0,7.852813852813853,0.24780726519857127
1699,240,243,3,0,0,8.909465020576132,0.31408359691187254
1700,4,239,235,0,0,7.092050209205021,0.31081888822474957
1701,34,239,205,0,0,7.481171548117155,0.2675011427165006
1702,228,238,10,0,0,8.735294117647058,0.27984611566145895
1703,0,233,233,0,0,6.785407725321888,0.2727171821814424
1704,234,234,0,0,0,9.102564102564102,0.29844833278309435
1705,3,234,231,0,0,7.021367521367521,0.2699277355929705
1706,0,245,245,0,0,6.653061224489796,0.27668116426898676
1707,183,230,47,0,0,8.352173913043478,0.2640782228972887
1708,0,241,241,0,0,6.531120331950207,0.2750691562932237
1709,1,231,230,0,0,7.255411255411255,0.3040466779597251
1710,225,238,13,0,0,8.600840336134453,0.29991490266992926
1711,0,238,238,0,0,6.029411764705882,0.324025812856791
1712,15,231,216,0,0,7.354978354978355,0.28213815170337236
1713,245,245,0,0,0,9.383673469387755,0.2620274339243954
1714,15,229,214,0,0,7.3056768558951966,0.3096606144181431
1715,4,240,236,0,0,7.066666666666666,0.23821478382147482
1716,19,228,209,0,0,7.473684210526316,0.2768374681196404
1717,46,240,194,0,0,7.620833333333334,0.294961645746161
1718,231,231,0,0,0,9.982683982683982,0.29535102578580413
1719,0,231,231,0,0,6.1645021645021645,0.3206474684735519
1720,0,227,227,0,0,6.814977973568282,0.31959767650384324
1721,0,234,234,0,0,6.752136752136752,0.2730640842228826
1722,22,240,218,0,0,7.570833333333334,0.27948047419804845
1723,0,232,232,0,0,6.456896551724138,0.2838483355724716
1724,240,240,0,0,0,10.7375,0.2780857740585835
1725,0,229,229,0,0,7.026200873362446,0.21860874894659982
1726,222,241,19,0,0,8.634854771784232,0.2661134163208923
1727,237,237,0,0,0,10.379746835443038,0.27043552885646993
1728,1,243,242,0,0,6.658436213991769,0.2588851477740335
1729,3,241,238,0,0,7.062240663900415,0.2502766251728872
1730,61,243,182,0,0,7.695473251028806,0.26225215114104045
1731,1,243,242,0,0,6.810699588477366,0.2532734754956985
1732,69,239,170,0,0,7.7656903765690375,0.3146162230582644
1733,5,239,234,0,0,7.142259414225942,0.24858478956436458
1734,233,235,2,0,0,8.923404255319149,0.2847063102382315
1735,31,239,208,0,0,7.598326359832636,0.28335853169719943
1736,232,233,1,0,0,9.145922746781116,0.29758028710966755
1737,0,239,239,0,0,6.799163179916318,0.23680601947891788
1738,30,242,212,0,0,7.533057851239669,0.27483625390075955
1739,0,242,242,0,0,6.768595041322314,0.2532834950790434
1740,100,242,142,0,0,7.859504132231405,0.2955317033023547
1741,163,231,68,0,0,8.225108225108226,0.2969320534537948
1742,2,230,228,0,0,7.182608695652174,0.2547180558192524
1743,0,238,238,0,0,6.512605042016807,0.27621175052299496
1744,101,245,144,0,0,7.848979591836735,0.2844764135162282
1745,0,231,231,0,0,6.688311688311688,0.27634105025409433
1746,219,238,19,0,0,8.596638655462185,0.30918696592560363
1747,0,233,233,0,0,6.8068669527897,0.23409057273937803
1748,59,243,184,0,0,7.748971193415638,0.29622827602625795
1749,1,230,229,0,0,6.552173913043478,0.31822669451300767
1750,21,238,217,0,0,7.466386554621849,0.2836754955146582
1751,0,239,239,0,0,6.313807531380753,0.28346401322034903
1752,15,227,212,0,0,7.409691629955947,0.2606136213013103
1753,149,241,92,0,0,8.091286307053942,0.2666320885200548
1754,0,236,236,0,0,5.991525423728813,0.27226830147854036
1755,229,229,0,0,0,9.816593886462883,0.29077606680457074
1756,0,238,238,0,0,6.138655462184874,0.2549551466156102
1757,184,230,46,0,0,8.295652173913043,0.25281944180747956
1758,30,245,215,0,0,7.518367346938776,0.2916694546671113
1759,0,225,225,0,0,6.395555555555555,0.28480158730159083
1760,244,244,0,0,0,9.96311475409836,0.2908149497402687
1761,3,232,229,0,0,7.099137931034483,0.3061464397671278
1762,0,232,232,0,0,6.413793103448276,0.29556650246305444
1763,79,244,165,0,0,7.819672131147541,0.27187478917897545
1764,0,238,238,0,0,6.361344537815126,0.28238130695316294
1765,3,239,236,0,0,7.129707112970712,0.2730213424281813
1766,235,246,11,0,0,8.752032520325203,0.26071013771362805
1767,21,243,222,0,0,7.493827160493828,0.2757881848790945
1768,3,246,243,0,0,7.073170731707317,0.2885017421602762
1769,0,230,230,0,0,6.317391304347826,0.2787355230681607
1770,3,236,233,0,0,7.063559322033898,0.2640281283808129
1771,74,245,171,0,0,7.8040816326530615,0.25654064904650664
1772,245,245,0,0,0,10.86530612244898,0.25637336901974
1773,0,232,232,0,0,6.155172413793103,0.2615315718763959
1774,0,227,227,0,0,6.0176211453744495,0.2917235195508937
1775,244,244,0,0,0,10.020491803278688,0.3164507859407643
1776,59,240,181,0,0,7.691666666666666,0.25599721059971753
1777,0,231,231,0,0,6.03030303030303,0.2642951251646873
1778,114,245,131,0,0,8.036734693877552,0.29782535965205914
1779,235,235,0,0,0,10.042553191489361,0.30587379523549474
1780,67,232,165,0,0,7.788793103448276,0.28853187042842243
1781,125,230,105,0,0,8.082608695652175,0.303189671539778
1782,14,240,226,0,0,7.416666666666667,0.30264993026499554
1783,9,231,222,0,0,7.251082251082251,0.31929230190099867
1784,8,227,219,0,0,7.1233480176211454,0.3475498031265834
1785,0,236,236,0,0,6.271186440677966,0.2921024161557843
1786,0,234,234,0,0,6.2094017094017095,0.27785114265801025
1787,0,231,231,0,0,6.225108225108225,0.25345379258422956
1788,229,230,1,0,0,8.88695652173913,0.24917410290488662
1789,0,242,242,0,0,6.768595041322314,0.2947772710126534
1790,231,231,0,0,0,9.519480519480519,0.2594014680971273
1791,246,246,0,0,0,10.808943089430894,0.2694707151153125
1792,0,235,235,0,0,6.885106382978724,0.2645208219676292
1793,69,238,169,0,0,7.819327731092437,0.2836754955146582
1794,7,230,223,0,0,7.21304347826087,0.273191570153787
1795,0,236,236,0,0,6.2923728813559325,0.2588351965380462
1796,109,230,121,0,0,7.908695652173913,0.2929371558762065
1797,82,231,149,0,0,7.761904761904762,0.31262939958591945
1798,131,245,114,0,0,8.008163265306122,0.23763800602207874
1799,0,233,233,0,0,6.721030042918455,0.3485644516797414
1800,0,236,236,0,0,6.059322033898305,0.2517850703209486
1801,0,241,241,0,0,6.427385892116183,0.2624135546334704
1802,246,246,0,0,0,10.699186991869919,0.2846523975443846
1803,2,229,227,0,0,6.9825327510917035,0.29793917107178314
1804,128,230,102,0,0,8.043478260869565,0.3037782418834237
1805,234,234,0,0,0,9.474358974358974,0.27616375041267144
1806,41,242,201,0,0,7.698347107438017,0.31941634374678535
1807,37,232,195,0,0,7.629310344827586,0.28623675175399177
1808,235,240,5,0,0,8.875,0.2186192468619247
1809,74,243,169,0,0,7.748971193415638,0.27143488759650586
1810,234,234,0,0,0,10.495726495726496,0.3025567660760797
1811,0,233,233,0,0,6.266094420600858,0.2909575255290794
1812,0,231,231,0,0,6.545454545454546,0.2837944664031649
1813,115,244,129,0,0,7.959016393442623,0.26991837010052067
1814,1,239,238,0,0,6.912133891213389,0.2569529904011833
1815,245,245,0,0,0,9.412244897959184,0.2924723987955792
1816,1,233,232,0,0,6.613733905579399,0.33291401509545876
1817,33,234,201,0,0,7.632478632478633,0.2677818128461894
1818,35,231,196,0,0,7.58008658008658,0.32290607942781524
1819,2,230,228,0,0,6.939130434782609,0.30195557243212723
1820,0,230,230,0,0,6.326086956521739,0.23818112777672473
1821,0,244,244,0,0,6.385245901639344,0.2624974701477425
1822,7,236,229,0,0,7.279661016949152,0.23635052289938996
1823,245,245,0,0,0,10.49795918367347,0.2920040147206445
1824,1,229,228,0,0,7.021834061135372,0.2319773232207138
1825,244,244,0,0,0,9.89344262295082,0.30958645348444613
1826,1,239,238,0,0,6.941422594142259,0.3158820013360976
1827,106,231,125,0,0,8.004329004329005,0.2738942217203104
1828,10,230,220,0,0,7.317391304347826,0.30493639643060605
1829,0,239,239,0,0,6.075313807531381,0.2464048380858584
1830,0,234,234,0,0,6.299145299145299,0.2792267341623527
1831,0,230,230,0,0,6.326086956521739,0.2469147522308732
1832,0,228,228,0,0,6.026315789473684,0.22837931833990474
1833,1,229,228,0,0,6.903930131004367,0.23634413544778796
1834,238,238,0,0,0,9.6890756302521,0.299542601850862
1835,71,230,159,0,0,7.7956521739130435,0.3205050313271302
1836,0,233,233,0,0,6.369098712446352,0.2511099600414409
1837,238,238,0,0,0,10.38655462184874,0.27188596957769845
1838,206,228,22,0,0,8.486842105263158,0.26854857407837024
1839,0,241,241,0,0,6.659751037344399,0.2587482710926679
1840,44,235,191,0,0,7.634042553191489,0.3014002545917401
1841,0,242,242,0,0,6.119834710743802,0.2801858646822793
1842,0,243,243,0,0,6.288065843621399,0.27204707002686873
1843,0,226,226,0,0,6.438053097345133,0.2739233038348094
1844,247,247,0,0,0,10.983805668016194,0.20298871004904764
1845,124,243,119,0,0,7.962962962962963,0.25068870523415726
1846,41,233,192,0,0,7.600858369098712,0.2753440876128464
1847,236,236,0,0,0,10.40677966101695,0.2593580959249905
1848,223,232,9,0,0,8.702586206896552,0.2618114643976724
1849,238,238,0,0,0,10.016806722689076,0.30351381058753296
1850,93,227,134,0,0,7.9118942731277535,0.3196366613387386
1851,71,235,164,0,0,7.7106382978723405,0.30052736861247636
1852,23,236,213,0,0,7.470338983050848,0.2927335016227942
1853,35,235,200,0,0,7.6,0.2581196581196566
1854,0,237,237,0,0,6.780590717299578,0.256740327540583
1855,3,242,239,0,0,6.913223140495868,0.2870443400432093
1856,237,237,0,0,0,9.573839662447257,0.28795680469140617
1857,230,230,0,0,0,10.11304347826087,0.24044047845073815
1858,246,246,0,0,0,9.5,0.2673469387755102
1859,0,226,226,0,0,6.376106194690266,0.280137659783674
1860,6,242,236,0,0,7.1735537190082646,0.3017043311271939
1861,21,242,221,0,0,7.417355371900826,0.2773738897842983
1862,0,241,241,0,0,6.668049792531121,0.2976832641770367
1863,44,231,187,0,0,7.567099567099567,0.27265198569546
1864,231,231,0,0,0,10.675324675324676,0.27238848108412955
1865,176,239,63,0,0,8.297071129707113,0.2433107134067021
1866,1,226,225,0,0,6.610619469026549,0.30104228121927007
1867,1,237,236,0,0,6.919831223628692,0.24354573410569869
1868,241,241,0,0,0,9.46058091286307,0.291147994467489
1869,233,233,0,0,0,9.982832618025752,0.29280745893148097
1870,0,243,243,0,0,6.366255144032922,0.2826582321531833
1871,232,232,0,0,0,9.762931034482758,0.26823033288550097
1872,0,231,231,0,0,6.406926406926407,0.2684735554300736
1873,239,239,0,0,0,10.518828451882845,0.2843078654055839
1874,2,240,238,0,0,6.6375,0.2739016736401658
1875,4,242,238,0,0,7.128099173553719,0.2532320565138336
1876,88,229,141,0,0,7.93886462882096,0.26817589826093846
1877,232,232,0,0,0,10.327586206896552,0.2904911180773261
1878,213,245,32,0,0,8.477551020408164,0.2669120107059184
1879,239,239,0,0,0,9.807531380753138,0.2905312752716155
1880,233,233,0,0,0,10.437768240343347,0.28167085984904555
1881,44,244,200,0,0,7.659836065573771,0.2665283680766406
1882,241,241,0,0,0,10.66804979253112,0.2976832641770367
1883,51,228,177,0,0,7.6535087719298245,0.26267485895355114
1884,50,232,182,0,0,7.685344827586207,0.25987087625018823
1885,3,228,225,0,0,6.951754385964913,0.2840057191436761
1886,243,243,0,0,0,10.559670781893004,0.28051559364690204
1887,182,234,52,0,0,8.294871794871796,0.2603169362825997
1888,0,231,231,0,0,6.125541125541125,0.2667795972143801
1889,246,246,0,0,0,10.43089430894309,0.2625518500082948
1890,4,229,225,0,0,7.026200873362446,0.27124032789396824
1891,0,233,233,0,0,6.725321888412017,0.2604336243895244
1892,2,238,236,0,0,7.092436974789916,0.28677800234017997
1893,0,237,237,0,0,6.518987341772152,0.26764642780519077
1894,1,237,236,0,0,7.10126582278481,0.2863119502252769
1895,7,241,234,0,0,7.1161825726141075,0.27811203319502054
1896,229,231,2,0,0,8.896103896103897,0.25002823263693363
1897,0,230,230,0,0,6.160869565217391,0.2753180178469728
1898,45,235,190,0,0,7.608510638297872,0.29052555010002057
1899,232,232,0,0,0,10.668103448275861,0.28330721003135395
1900,6,229,223,0,0,7.078602620087336,0.3008120738527555
1901,236,236,0,0,0,10.639830508474576,0.2569599711503852
1902,0,233,233,0,0,6.115879828326181,0.2839277785999692
1903,187,234,47,0,0,8.363247863247864,0.3352958438795349
1904,141,236,95,0,0,8.097457627118644,0.32663180670753444
1905,83,238,155,0,0,7.878151260504202,0.31842357196043314
1906,240,240,0,0,0,9.758333333333333,0.2593444909344501
1907,0,240,240,0,0,6.0,0.24267782426778242
1908,0,227,227,0,0,6.237885462555066,0.22634595142489186
1909,0,240,240,0,0,6.254166666666666,0.29077754532775096
1910,44,246,202,0,0,7.58130081300813,0.27703666832586554
1911,0,231,231,0,0,6.3896103896103895,0.28232636928289295
1912,1,244,243,0,0,7.032786885245901,0.2952168926667994
1913,32,243,211,0,0,7.5473251028806585,0.27357752610277963
1914,0,229,229,0,0,6.550218340611353,0.2661074082586406
1915,127,242,115,0,0,8.016528925619834,0.26528582696066894
1916,144,241,97,0,0,8.091286307053942,0.25829875518672146
1917,11,227,216,0,0,7.312775330396476,0.2512962457604023
1918,0,234,234,0,0,6.52991452991453,0.2845090055390459
1919,231,231,0,0,0,9.493506493506494,0.3119141727837458
1920,239,239,0,0,0,10.150627615062762,0.2713336380577345
1921,1,242,241,0,0,6.702479338842975,0.3177531634717608
1922,162,236,74,0,0,8.182203389830509,0.30283086909484486
1923,90,232,142,0,0,7.892241379310345,0.25240707568293963
1924,246,246,0,0,0,10.357723577235772,0.29600132736021045
1925,29,231,202,0,0,7.562770562770563,0.2558253340862037
1926,0,227,227,0,0,7.008810572687224,0.2654087559939181
1927,16,234,218,0,0,7.435897435897436,0.27269725982172094
1928,240,242,2,0,0,9.012396694214877,0.3193477589931823
1929,93,229,136,0,0,7.860262008733624,0.26986133455910566
1930,4,244,240,0,0,7.081967213114754,0.2895500236119518
1931,233,244,11,0,0,8.692622950819672,0.2631552317344721
1932,111,240,129,0,0,8.016666666666667,0.250767085076705
1933,232,232,0,0,0,10.495689655172415,0.25972160023884816
1934,242,242,0,0,0,9.50413223140496,0.25931895339665395
1935,66,231,165,0,0,7.683982683982684,0.3040466779597251
1936,1,244,243,0,0,6.909836065573771,0.2716724009984513
1937,0,237,237,0,0,6.540084388185654,0.2833440606450726
1938,246,246,0,0,0,9.3130081300813,0.25672805707648394
1939,0,237,237,0,0,6.30801687763713,0.23946935564614036
1940,0,228,228,0,0,6.2894736842105265,0.2858798979828413
1941,0,238,238,0,0,6.642857142857143,0.2643158529234468
1942,240,240,0,0,0,9.604166666666666,0.24851813110180804
1943,244,244,0,0,0,10.10655737704918,0.2602037374350634
1944,184,229,45,0,0,8.37117903930131,0.2782885160499494
1945,38,242,204,0,0,7.56198347107438,0.3052707383148763
1946,99,233,134,0,0,7.92274678111588,0.2267648364658867
1947,16,232,216,0,0,7.331896551724138,0.2919652186893547
1948,126,235,109,0,0,8.042553191489361,0.2716857610474605
1949,0,230,230,0,0,6.495652173913044,0.2947408391873938
1950,1,244,243,0,0,6.897540983606557,0.2651791135397657
1951,6,245,239,0,0,7.106122448979592,0.30836400133823755
1952,7,240,233,0,0,7.329166666666667,0.23847629009762547
1953,3,233,230,0,0,6.909871244635193,0.2806348971437038
1954,123,233,110,0,0,8.03862660944206,0.31315672635785097
1955,0,230,230,0,0,6.1521739130434785,0.28678564647807
1956,244,244,0,0,0,10.09016393442623,0.2881333063482455
1957,0,241,241,0,0,6.556016597510373,0.2812240663900411
1958,224,243,19,0,0,8.518518518518519,0.2672176308539995
1959,0,234,234,0,0,6.299145299145299,0.30497780712372613
1960,205,242,37,0,0,8.380165289256198,0.27811117588560635
1961,59,233,174,0,0,7.703862660944206,0.29554536036702583
1962,0,240,240,0,0,6.020833333333333,0.3133716875871713
1963,234,234,0,0,0,10.893162393162394,0.2675066945453162
1964,0,229,229,0,0,6.580786026200873,0.2796292040143989
1965,66,239,173,0,0,7.7531380753138075,0.2707359094265332
1966,232,232,0,0,0,10.762931034482758,0.2768883415435096
1967,34,234,200,0,0,7.551282051282051,0.2655992076592929
1968,16,237,221,0,0,7.3881856540084385,0.28935135521704963
1969,6,234,228,0,0,7.222222222222222,0.276585598474014
1970,6,233,227,0,0,7.103004291845494,0.3427926594642627
1971,143,243,100,0,0,8.148148148148149,0.29201101928374407
1972,0,243,243,0,0,6.666666666666667,0.2727272727272727
1973,67,230,163,0,0,7.8,0.2567685589519619
1974,0,229,229,0,0,6.11353711790393,0.2677545391863947
1975,176,242,66,0,0,8.194214876033058,0.26502863413463496
1976,245,246,1,0,0,9.182926829268293,0.2725236436037783
1977,77,242,165,0,0,7.776859504132231,0.2819519220877235
1978,41,240,199,0,0,7.533333333333333,0.2582984658298476
1979,246,246,0,0,0,9.613821138211382,0.2869918699186962
1980,14,230,216,0,0,7.352173913043479,0.28154547180558565
1981,0,226,226,0,0,6.066371681415929,0.2577974434611598
1982,52,237,185,0,0,7.666666666666667,0.28248587570621214
1983,18,240,222,0,0,7.391666666666667,0.28947001394699784
1984,45,229,184,0,0,7.668122270742358,0.2841109323527123
1985,1,237,236,0,0,6.919831223628692,0.268969462919258
1986,0,233,233,0,0,6.5965665236051505,0.27619505697794794
1987,0,242,242,0,0,6.086776859504132,0.3368368711635412
1988,96,236,140,0,0,7.877118644067797,0.3124954922466636
1989,233,234,1,0,0,9.17094017094017,0.27966692344375293
1990,0,233,233,0,0,6.635193133047211,0.2585836909871228
1991,243,243,0,0,0,10.954732510288066,0.266537428153588
1992,226,233,7,0,0,8.656652360515022,0.26091460707413777
1993,20,242,222,0,0,7.3884297520661155,0.29662905936010137
1994,25,242,217,0,0,7.487603305785124,0.2757792942628843
1995,0,243,243,0,0,6.271604938271605,0.2399755127027885
1996,92,245,153,0,0,7.8244897959183675,0.35021746403479065
1997,7,239,232,0,0,7.2719665271966525,0.2996730072782233
1998,93,233,140,0,0,7.905579399141631,0.33587390853929344
1999,112,241,129,0,0,7.954356846473029,0.27707468879668035
2000,1,240,239,0,0,6.679166666666666,0.2773884239888434
2001,0,242,242,0,0,6.632231404958677,0.2666746682212512
2002,0,229,229,0,0,6.14410480349345,0.2730023749329695
2003,0,243,243,0,0,6.374485596707819,0.2930653334693744
2004,236,236,0,0,0,9.80084745762712,0.27080778939775785
2005,73,241,168,0,0,7.821576763485477,0.24719917012447848
2006,0,241,241,0,0,6.7053941908713695,0.2670124481327775
2007,0,238,238,0,0,6.680672268907563,0.28578520015600845
2008,244,244,0,0,0,10.581967213114755,0.2607434392498194
2009,234,234,0,0,0,10.863247863247864,0.2558967022486258
2010,87,233,146,0,0,7.76824034334764,0.29950421784816045
2011,245,245,0,0,0,10.19591836734694,0.25654064904650664
2012,0,240,240,0,0,6.791666666666667,0.3078800557880081
2013,0,237,237,0,0,6.2784810126582276,0.28652649645999007
2014,234,234,0,0,0,10.465811965811966,0.2498991232896827
2015,121,236,115,0,0,7.995762711864407,0.20849260728452676
2016,5,243,238,0,0,7.160493827160494,0.25099479644934247
2017,0,234,234,0,0,6.2094017094017095,0.24351637870951243
2018,0,239,239,0,0,6.058577405857741,0.2738651946134085
2019,113,229,116,0,0,8.004366812227074,0.25875277713935485
2020,239,239,0,0,0,10.702928870292887,0.28532752012939117
2021,0,242,242,0,0,6.297520661157025,0.26796063235142886
2022,3,232,229,0,0,6.887931034482759,0.28175847141364735
2023,0,226,226,0,0,6.367256637168142,0.27785644051130576
2024,13,231,218,0,0,7.415584415584416,0.3047995482778076
2025,2,242,240,0,0,7.128099173553719,0.2698295668872776
2026,4,229,225,0,0,7.179039301310044,0.2353481958170561
2027,0,243,243,0,0,6.0246913580246915,0.2803795531068272
2028,231,231,0,0,0,10.519480519480519,0.2767927724449533
2029,0,243,243,0,0,6.193415637860082,0.2723531612420464
2030,6,239,233,0,0,7.163179916317992,0.2715797616117604
2031,0,241,241,0,0,6.580912863070539,0.2861341632088549
2032,23,237,214,0,0,7.556962025316456,0.26475005363655496
2033,0,227,227,0,0,6.612334801762114,0.2738294803321532
2034,5,239,234,0,0,7.175732217573222,0.25470271790724663
2035,117,242,125,0,0,8.016528925619834,0.2984808477075569
2036,3,240,237,0,0,7.1,0.24937238493724
2037,9,231,222,0,0,7.259740259740259,0.2974590626764557
2038,239,239,0,0,0,10.841004184100418,0.2603283991420769
2039,0,231,231,0,0,6.515151515151516,0.2943346508563912
2040,244,244,0,0,0,10.73360655737705,0.24561492275518096
2041,0,228,228,0,0,6.9868421052631575,0.24211685601669625
2042,242,246,4,0,0,8.955284552845528,0.31227808196448936
2043,146,234,88,0,0,8.132478632478632,0.2699277355929705
2044,1,241,240,0,0,7.08298755186722,0.26808437067772956
2045,114,246,132,0,0,7.963414634146342,0.30477849676456253
2046,12,231,219,0,0,7.3982683982683985,0.2841709015622062
2047,5,237,232,0,0,7.143459915611814,0.25899306300507924
2048,1,243,242,0,0,6.802469135802469,0.3409856137128853
2049,0,243,243,0,0,6.724279835390947,0.27490392136856706
2050,0,238,238,0,0,6.7100840336134455,0.29112151189589514
2051,138,242,104,0,0,8.053719008264462,0.3000068584753603
2052,56,231,175,0,0,7.740259740259741,0.2626764539808035
2053,2,227,225,0,0,7.066079295154185,0.3186230556313555
2054,81,228,147,0,0,7.868421052631579,0.2645490377927163
2055,231,231,0,0,0,10.242424242424242,0.24532279314888633
2056,33,232,199,0,0,7.525862068965517,0.302358560979249
2057,63,236,173,0,0,7.669491525423729,0.2902993148214901
2058,235,235,0,0,0,10.54468085106383,0.27470449172577566
2059,1,244,243,0,0,6.909836065573771,0.2716724009984513
2060,38,237,199,0,0,7.514767932489452,0.2847386111707083
2061,108,236,128,0,0,7.991525423728813,0.22971510998917863
2062,23,240,217,0,0,7.5,0.2594142259414226
2063,0,239,239,0,0,6.631799163179917,0.2924299426883691
2064,0,241,241,0,0,6.3112033195020745,0.30691562932227046
2065,28,233,205,0,0,7.463519313304721,0.3273272162202124
2066,2,237,235,0,0,7.2405063291139244,0.2766573696631602
2067,229,234,5,0,0,8.764957264957266,0.2492388393675902
2068,0,227,227,0,0,6.757709251101321,0.25519472925032105
2069,0,240,240,0,0,6.683333333333334,0.26750348675034513
2070,243,243,0,0,0,10.390946502057613,0.2804135632418478
2071,0,225,225,0,0,5.9688888888888885,0.26242063492063444
2072,229,233,4,0,0,8.905579399141631,0.24104632233238904
2073,233,233,0,0,0,9.901287553648068,0.2790069557495999
2074,0,229,229,0,0,6.069868995633188,0.27579866697310773
2075,0,230,230,0,0,6.256521739130434,0.2614201632808084
2076,91,245,154,0,0,7.816326530612245,0.24891267982603182
2077,5,240,235,0,0,7.25,0.3054393305439331
2078,28,232,204,0,0,7.495689655172414,0.27703761755485756
2079,0,244,244,0,0,6.717213114754099,0.25303582270795166
2080,8,233,225,0,0,7.227467811158799,0.24544916383010315
2081,5,239,234,0,0,7.154811715481172,0.34147885095460556
2082,17,240,223,0,0,7.2875,0.2559100418410057
2083,214,244,30,0,0,8.487704918032787,0.30849018417323765
2084,0,228,228,0,0,6.614035087719298,0.28209289744184024
2085,0,227,227,0,0,5.955947136563877,0.29008615648512914
2086,0,230,230,0,0,6.608695652173913,0.2828934877539389
2087,0,233,233,0,0,5.987124463519313,0.28000591978688416
2088,41,244,203,0,0,7.618852459016393,0.2944579369898152
2089,0,244,244,0,0,6.307377049180328,0.26315523173446465
2090,0,240,240,0,0,6.145833333333333,0.284082984658301
2091,24,245,221,0,0,7.481632653061224,0.26707929073268505
2092,219,240,21,0,0,8.545833333333333,0.29077754532775857
2093,6,239,233,0,0,7.2510460251046025,0.2896522625786692
2094,207,239,32,0,0,8.451882845188285,0.28233887697337684
2095,124,229,105,0,0,8.030567685589519,0.24906151842487975
2096,0,240,240,0,0,6.079166666666667,0.29914574616457107
2097,14,232,218,0,0,7.396551724137931,0.3009404388714709
2098,126,232,106,0,0,8.02155172413793,0.30689281982385186
2099,238,239,1,0,0,9.171548117154812,0.28557364368340943
2100,232,232,0,0,0,9.461206896551724,0.27554485744140156
2101,242,242,0,0,0,9.793388429752065,0.28908473646308824
2102,234,234,0,0,0,9.2008547008547,0.2727889659220094
2103,0,235,235,0,0,6.3872340425531915,0.272485906528462
2104,0,242,242,0,0,5.979338842975206,0.26098213367168605
2105,201,238,37,0,0,8.453781512605042,0.28266496472006036
2106,17,238,221,0,0,7.46218487394958,0.2580576534411243
2107,49,232,183,0,0,7.637931034482759,0.3185550082101842
2108,218,244,26,0,0,8.577868852459016,0.3025534642110271
2109,8,238,230,0,0,7.340336134453781,0.31828174307697676
2110,26,242,216,0,0,7.483471074380165,0.25076300538390545
2111,0,236,236,0,0,6.588983050847458,0.2686440677966064
2112,0,232,232,0,0,6.693965517241379,0.256586804000596
2113,0,237,237,0,0,6.080168776371308,0.345240649359936
2114,0,228,228,0,0,6.12719298245614,0.2524731432104451
2115,119,241,122,0,0,7.991701244813278,0.2749308437067763
2116,226,237,11,0,0,8.772151898734178,0.2783737395408734
2117,0,232,232,0,0,6.189655172413793,0.2842215256008376
2118,1,242,241,0,0,6.87603305785124,0.29162237234662697
2119,0,240,240,0,0,6.0125,0.31365062761506124
2120,4,230,226,0,0,6.982608695652174,0.24423770647427578
2121,247,247,0,0,0,11.016194331983806,0.28428952305717775
2122,241,241,0,0,0,10.780082987551868,0.24726832641770974
2123,17,235,218,0,0,7.523404255319149,0.29325331878523225
2124,225,228,3,0,0,9.157894736842104,0.3009506144215121
2125,224,234,10,0,0,8.705128205128204,0.30323539121822984
2126,245,245,0,0,0,9.869387755102041,0.28614921378387215
2127,233,233,0,0,0,9.523605150214593,0.2850007399733684
2128,42,239,197,0,0,7.665271966527197,0.25723427446292063
2129,1,232,231,0,0,6.844827586206897,0.2701895805344046
2130,234,237,3,0,0,8.932489451476794,0.3089823356933451
2131,233,233,0,0,0,11.03862660944206,0.25281189877164406
2132,0,243,243,0,0,6.617283950617284,0.27854300581573116
2133,0,228,228,0,0,6.754385964912281,0.24777803539686247
2134,243,243,0,0,0,10.415637860082304,0.2769445294697791
2135,71,228,157,0,0,7.7631578947368425,0.26964989566427333
2136,21,232,211,0,0,7.512931034482759,0.26823033288550885
2137,245,245,0,0,0,10.489795918367347,0.34928069588490646
2138,245,245,0,0,0,9.453061224489796,0.2815991970558675
2139,0,229,229,0,0,6.462882096069869,0.3023442886692704
2140,242,242,0,0,0,10.599173553719009,0.27435616062548546
2141,0,228,228,0,0,6.043859649122807,0.2711956101707975
2142,232,232,0,0,0,9.698275862068966,0.25488878937154147
2143,3,236,233,0,0,7.038135593220339,0.27513523260006856
2144,236,236,0,0,0,9.533898305084746,0.309484313018394
2145,199,234,35,0,0,8.401709401709402,0.27570521991122915
2146,1,226,225,0,0,6.734513274336283,0.2758702064896756
2147,105,238,133,0,0,7.953781512605042,0.28899407864411863
2148,0,234,234,0,0,6.773504273504273,0.28753530684861184
2149,0,237,237,0,0,6.0042194092827,0.28388042623185555
2150,191,236,45,0,0,8.432203389830509,0.28900108186079454
2151,0,230,230,0,0,6.047826086956522,0.2990127207138826
2152,0,236,236,0,0,6.466101694915254,0.2754417598269046
2153,51,231,180,0,0,7.70995670995671,0.2763786937699953
2154,0,243,243,0,0,6.1646090534979425,0.28684147876066907
2155,0,232,232,0,0,6.6594827586206895,0.26882743693088496
2156,64,242,178,0,0,7.764462809917355,0.28039161894311104
2157,110,234,124,0,0,7.952991452991453,0.2767506694545332
2158,238,238,0,0,0,10.445378151260504,0.2649363542885511
2159,232,232,0,0,0,9.758620689655173,0.28780414987311
2160,244,244,0,0,0,10.008196721311476,0.2797679282196557
2161,232,232,0,0,0,10.379310344827585,0.30571727123451914
2162,0,245,245,0,0,5.995918367346939,0.2663767146202756
2163,237,237,0,0,0,10.10548523206751,0.2557748694843814
2164,76,245,169,0,0,7.7306122448979595,0.2713951154232149
2165,229,229,0,0,0,9.174672489082969,0.2939171071784266
2166,0,237,237,0,0,6.0548523206751055,0.2215547450475581
2167,246,246,0,0,0,9.699186991869919,0.30097892815662947
2168,0,231,231,0,0,6.658008658008658,0.2607942781855815
2169,118,241,123,0,0,8.024896265560166,0.2743775933609944
2170,17,232,215,0,0,7.353448275862069,0.2901179280489601
2171,17,236,219,0,0,7.411016949152542,0.2941759826902234
2172,0,240,240,0,0,5.970833333333333,0.2543758716875882
2173,64,235,171,0,0,7.659574468085107,0.2853246044735423
2174,247,247,0,0,0,9.518218623481781,0.25881307396070397
2175,242,242,0,0,0,9.47107438016529,0.266794691540064
2176,0,236,236,0,0,6.584745762711864,0.26938333934367426
2177,5,243,238,0,0,7.275720164609053,0.2831683841784844
2178,0,225,225,0,0,6.328888888888889,0.2931349206349166
2179,213,235,22,0,0,8.485106382978723,0.2679396253864295
2180,0,236,236,0,0,6.1440677966101696,0.2940497655968276
2181,0,238,238,0,0,6.063025210084033,0.3040279402900412
2182,29,230,201,0,0,7.621739130434783,0.2536738181127805
2183,1,243,242,0,0,7.082304526748971,0.29071863415297716
2184,20,227,207,0,0,7.5506607929515415,0.2662274375268004
2185,109,243,134,0,0,7.872427983539095,0.3018399483045929
2186,3,230,227,0,0,7.2043478260869565,0.2943041579646848
2187,16,234,218,0,0,7.363247863247863,0.28379369795678816
2188,232,243,11,0,0,8.637860082304528,0.27327143488760197
2189,245,245,0,0,0,10.338775510204082,0.27410505185680895
2190,0,238,238,0,0,6.298319327731092,0.26927986384427394
2191,0,239,239,0,0,6.489539748953975,0.2761506276150643
2192,4,234,230,0,0,7.264957264957265,0.30717875353068813
2193,51,243,192,0,0,7.679012345679013,0.2684419957147252
2194,243,243,0,0,0,9.094650205761317,0.31745060027888705
2195,0,240,240,0,0,6.341666666666667,0.27608089260809027
2196,100,241,141,0,0,7.9004149377593365,0.23170816044259937
2197,0,243,243,0,0,6.637860082304527,0.2567425092677597
2198,233,233,0,0,0,10.914163090128755,0.2770830250110991
2199,232,232,0,0,0,10.331896551724139,0.30062322734737124
2200,3,244,241,0,0,7.069672131147541,0.26261552991971615
2201,239,239,0,0,0,10.694560669456067,0.27186104567350533
2202,236,236,0,0,0,10.427966101694915,0.2884060584204835
2203,72,234,162,0,0,7.735042735042735,0.36726459044055937
2204,247,247,0,0,0,10.433198380566802,0.27905598894046224
2205,0,236,236,0,0,6.563559322033898,0.2895600432744299
2206,9,234,225,0,0,7.1923076923076925,0.3019148233740526
2207,236,236,0,0,0,9.13135593220339,0.31884240894338445
2208,234,234,0,0,0,9.7008547008547,0.2878104251494772
2209,243,243,0,0,0,10.353909465020577,0.2626602727612874
2210,230,230,0,0,0,9.978260869565217,0.3095690146193355
2211,0,231,231,0,0,6.324675324675325,0.24630152456239043
2212,0,229,229,0,0,6.14410480349345,0.2642304451084081
2213,0,240,240,0,0,6.4875,0.26762552301255077
2214,13,227,214,0,0,7.497797356828194,0.25995087910802545
2215,47,237,190,0,0,7.624472573839663,0.2693985553886844
2216,118,244,126,0,0,8.01639344262295,0.2466437293395431
2217,0,243,243,0,0,6.757201646090535,0.25072271536917784
2218,0,228,228,0,0,6.206140350877193,0.26128371589766974
2219,3,244,241,0,0,7.065573770491803,0.283748229103419
2220,227,239,12,0,0,8.631799163179917,0.26721985865475567
2221,0,240,240,0,0,6.229166666666667,0.3029114365411462
2222,236,236,0,0,0,10.559322033898304,0.2730616660656295
2223,25,235,210,0,0,7.485106382978723,0.31067466812148004
2224,246,246,0,0,0,9.402439024390244,0.2577899452463851
2225,14,237,223,0,0,7.39662447257384,0.29117499821211174
2226,26,236,210,0,0,7.453389830508475,0.274413992066354
2227,9,237,228,0,0,7.375527426160337,0.2778731316598708
2228,37,244,207,0,0,7.561475409836065,0.2719253862241102
2229,116,245,129,0,0,7.963265306122449,0.2404483104717313
2230,8,245,237,0,0,7.183673469387755,0.273502843760458
2231,0,226,226,0,0,6.349557522123894,0.29059980334316304
2232,13,241,228,0,0,7.278008298755187,0.2765560165975103
2233,77,238,161,0,0,7.7899159663865545,0.2425983051448403
2234,4,230,226,0,0,7.173913043478261,0.24909815834441032
2235,42,242,200,0,0,7.578512396694215,0.2863413463187102
2236,0,229,229,0,0,6.6593886462882095,0.29575576495824607
2237,0,232,232,0,0,6.314655172413793,0.2512128675921796
2238,247,247,0,0,0,9.736842105263158,0.30038510911425526
2239,33,235,202,0,0,7.54468085106383,0.28325150027277646
2240,0,243,243,0,0,6.139917695473251,0.2613338774954924
2241,239,239,0,0,0,10.456066945606695,0.2827256425582714
2242,0,236,236,0,0,6.372881355932203,0.2773891092679402
2243,0,228,228,0,0,6.692982456140351,0.24893732127675963
2244,0,230,230,0,0,6.660869565217391,0.30370229732295534
2245,243,243,0,0,0,9.366255144032921,0.29092269496309314
2246,0,243,243,0,0,6.7818930041152266,0.2538856579260614
2247,240,240,0,0,0,10.5,0.2594142259414226
2248,0,232,232,0,0,6.737068965517241,0.33316539782057375
2249,246,246,0,0,0,10.284552845528456,0.2697195951551423
2250,237,237,0,0,0,10.556962025316455,0.29017378245011427
2251,9,239,230,0,0,7.087866108786611,0.2737597130902589
2252,15,234,219,0,0,7.414529914529915,0.2780712372987026
2253,113,239,126,0,0,7.97907949790795,0.264266376006468
2254,0,245,245,0,0,6.481632653061224,0.27527601204416047
2255,0,231,231,0,0,6.571428571428571,0.2633540372670841
2256,0,228,228,0,0,6.9035087719298245,0.3078290439755776
2257,1,240,239,0,0,6.775,0.2587866108786626
2258,0,229,229,0,0,6.493449781659389,0.27736918716004366
2259,0,232,232,0,0,6.943965517241379,0.269573816987609
2260,10,231,221,0,0,7.264069264069264,0.29952945605119846
2261,1,243,242,0,0,6.860082304526749,0.2695983403054098
2262,0,231,231,0,0,6.103896103896104,0.24133258046301267
2263,11,241,230,0,0,7.24896265560166,0.27109266943292215
2264,37,236,199,0,0,7.559322033898305,0.29008294266137413
2265,0,239,239,0,0,6.2175732217573225,0.30540417003621845
2266,41,232,191,0,0,7.586206896551724,0.2869084938050458
2267,1,228,227,0,0,6.9035087719298245,0.2902078986011282
2268,0,225,225,0,0,6.293333333333333,0.2528571428571403
2269,0,240,240,0,0,6.520833333333333,0.2924511854951211
2270,70,229,159,0,0,7.820960698689956,0.2792078449398631
2271,206,233,27,0,0,8.53648068669528,0.2669823886340055
2272,0,227,227,0,0,6.612334801762114,0.29152859537640097
2273,213,241,28,0,0,8.485477178423237,0.2758298755186691
2274,16,242,226,0,0,7.466942148760331,0.2831350090874815
2275,234,234,0,0,0,10.367521367521368,0.2849491948204461
2276,1,236,235,0,0,7.0,0.26382978723404255
2277,0,231,231,0,0,6.0562770562770565,0.2968191229060761
2278,243,243,0,0,0,10.695473251028806,0.2539876883311231
2279,90,230,140,0,0,7.913043478260869,0.28061515093981637
2280,231,231,0,0,0,10.86147186147186,0.3111613024656475
2281,32,233,201,0,0,7.592274678111588,0.28562971733017234
2282,0,236,236,0,0,6.148305084745763,0.33110349801658656
2283,2,235,233,0,0,7.046808510638298,0.2841243862520479
2284,0,230,230,0,0,6.404347826086957,0.28557053351053635
2285,4,229,225,0,0,7.1615720524017465,0.2676396230751555
2286,0,244,244,0,0,6.045081967213115,0.28190986979693794
2287,216,242,26,0,0,8.47107438016529,0.27509344672678604
2288,28,230,202,0,0,7.439130434782609,0.25610404404784776
2289,2,230,228,0,0,6.956521739130435,0.23390924625023596
2290,0,235,235,0,0,6.561702127659575,0.2814329878159635
2291,99,242,143,0,0,7.87603305785124,0.24182984122629503
2292,3,235,232,0,0,7.174468085106383,0.28139661756682843
2293,2,243,241,0,0,7.016460905349795,0.2559262660272734
2294,0,241,241,0,0,6.190871369294606,0.2717496542185321
2295,58,240,182,0,0,7.654166666666667,0.3192294281729438
2296,34,241,207,0,0,7.568464730290456,0.2963347164591975
2297,241,241,0,0,0,10.307053941908714,0.31365836791148166
2298,0,228,228,0,0,6.434210526315789,0.26437514491073416
2299,235,235,0,0,0,10.025531914893618,0.2728496090198277
2300,240,240,0,0,0,10.545833333333333,0.29077754532775857
2301,0,242,242,0,0,6.524793388429752,0.2587188368025821
2302,128,236,108,0,0,8.05084745762712,0.2612333213126592
2303,0,236,236,0,0,6.161016949152542,0.26332491886043613
2304,7,241,234,0,0,7.215767634854772,0.3032503457814679
2305,0,228,228,0,0,5.978070175438597,0.2770500038642853
2306,133,234,101,0,0,8.102564102564102,0.2812809508088454
2307,0,229,229,0,0,6.262008733624454,0.2468398069409296
2308,246,246,0,0,0,10.626016260162602,0.2677285548365629
2309,196,241,45,0,0,8.385892116182573,0.2879668049792599
2310,0,240,240,0,0,6.129166666666666,0.3388947001394665
2311,195,244,49,0,0,8.389344262295081,0.27988598799163683
2312,1,228,227,0,0,6.592105263157895,0.2954440064920047
2313,72,245,173,0,0,7.779591836734694,0.3118768819002995
2314,12,237,225,0,0,7.29957805907173,0.2615676178216375
2315,235,235,0,0,0,9.13191489361702,0.24320785597381037
2316,98,236,138,0,0,7.9025423728813555,0.2670573386224281
2317,72,229,157,0,0,7.751091703056769,0.25794836436068036
2318,0,243,243,0,0,7.131687242798354,0.28837193483657997
2319,15,228,213,0,0,7.390350877192983,0.24783599969085654
2320,3,243,240,0,0,6.909465020576132,0.3058191341019627
2321,0,229,229,0,0,6.8384279475982535,0.3027273423734011
2322,0,227,227,0,0,6.453744493392071,0.28435538575494507
2323,234,234,0,0,0,9.764957264957266,0.2749899123289636
2324,0,241,241,0,0,6.551867219917012,0.28167358229598755
2325,35,244,209,0,0,7.618852459016393,0.3109188423396095
2326,13,244,231,0,0,7.430327868852459,0.2790764352695104
2327,4,230,226,0,0,7.095652173913043,0.26155306626162805
2328,21,228,207,0,0,7.4298245614035086,0.28139732591390354
2329,0,227,227,0,0,6.427312775330397,0.28119761412810185
2330,0,226,226,0,0,6.106194690265487,0.29089478859390105
2331,8,239,231,0,0,7.338912133891213,0.26700889560844887
2332,1,244,243,0,0,6.938524590163935,0.25546448087431595
2333,9,238,229,0,0,7.201680672268908,0.24607311278942162
2334,14,234,220,0,0,7.401709401709402,0.2585378379369802
2335,138,238,100,0,0,8.067226890756302,0.2739424883877621
2336,237,237,0,0,0,9.329113924050633,0.27258099120360185
2337,60,228,168,0,0,7.824561403508772,0.22459231779890368
2338,0,238,238,0,0,6.777310924369748,0.2413395738042053
2339,237,237,0,0,0,9.375527426160337,0.2693985553886844
2340,0,227,227,0,0,6.669603524229075,0.23991267396982482
2341,233,233,0,0,0,9.261802575107296,0.27168121947609286
2342,0,241,241,0,0,5.991701244813278,0.31659751037344297
2343,0,232,232,0,0,6.435344827586207,0.2555418719211839
2344,0,226,226,0,0,6.017699115044247,0.3107964601769911
2345,0,238,238,0,0,6.5210084033613445,0.2843669113214907
2346,2,236,234,0,0,7.029661016949152,0.25869094843130486
2347,18,227,209,0,0,7.365638766519824,0.2949202760126322
2348,0,228,228,0,0,6.614035087719298,0.26447175206739093
2349,199,238,39,0,0,8.445378151260504,0.27337517285395196
2350,236,242,6,0,0,8.884297520661157,0.27701381982785217
2351,232,232,0,0,0,9.370689655172415,0.251604717121965
2352,0,235,235,0,0,6.297872340425532,0.2613202400436468
2353,238,240,2,0,0,8.754166666666666,0.28659344490934857
2354,0,231,231,0,0,6.606060606060606,0.283267457180504
2355,235,239,4,0,0,8.845188284518828,0.23223515347562163
2356,98,242,144,0,0,7.900826446280992,0.2888789822022565
2357,4,229,225,0,0,7.213973799126638,0.27418984141576674
2358,248,248,0,0,0,10.862903225806452,0.2564320229855077
2359,0,225,225,0,0,6.124444444444444,0.30587301587301646
2360,9,244,235,0,0,7.274590163934426,0.2987755515077954
2361,0,226,226,0,0,6.548672566371682,0.26650934119961067
2362,0,232,232,0,0,6.116379310344827,0.30241453948350744
2363,43,230,187,0,0,7.595652173913043,0.3030377824188333
2364,23,236,213,0,0,7.461864406779661,0.27513523260006856
2365,104,239,135,0,0,7.941422594142259,0.34949544671424887
2366,194,229,35,0,0,8.414847161572052,0.27890140197655855
2367,0,232,232,0,0,5.987068965517241,0.22926929392446987
2368,1,226,225,0,0,6.871681415929204,0.27235004916420924
2369,40,233,193,0,0,7.523605150214593,0.30224211928370537
2370,0,230,230,0,0,6.1521739130434785,0.23438389975317914
2371,129,244,115,0,0,8.012295081967213,0.2837988261485538
2372,0,235,235,0,0,6.56595744680851,0.2723404255319141
2373,15,244,229,0,0,7.311475409836065,0.27295419280847233
2374,243,243,0,0,0,9.62962962962963,0.2672176308539995
2375,0,234,234,0,0,6.0085470085470085,0.30035581966912545
2376,122,230,108,0,0,8.008695652173913,0.3143345357888766
2377,229,229,0,0,0,9.213973799126638,0.27418984141575875
2378,211,229,18,0,0,8.611353711790393,0.27373017697081786
2379,0,240,240,0,0,7.033333333333333,0.26666666666666766
2380,247,247,0,0,0,10.7165991902834,0.285211151706664
2381,230,242,12,0,0,8.652892561983471,0.2939542539693415
2382,8,243,235,0,0,7.242798353909465,0.27551610379892993
2383,0,230,230,0,0,6.417391304347826,0.2966394531991666
2384,245,245,0,0,0,10.457142857142857,0.27377049180327573
2385,10,244,234,0,0,7.266393442622951,0.28676718612966656
2386,104,243,139,0,0,7.897119341563786,0.2497024113185756
2387,0,228,228,0,0,6.105263157894737,0.2619986088569458
2388,0,229,229,0,0,6.807860262008734,0.2611660154753704
2389,64,230,166,0,0,7.734782608695652,0.32673248528574306
2390,73,235,162,0,0,7.804255319148936,0.26921258410620175
2391,0,230,230,0,0,6.6,0.29344978165939184
2392,43,236,193,0,0,7.635593220338983,0.3432383699963929
2393,0,234,234,0,0,5.9743589743589745,0.31693628260152046
2394,199,239,40,0,0,8.460251046025105,0.2830772476354621
2395,116,240,124,0,0,7.983333333333333,0.26750348675034513
2396,0,239,239,0,0,6.326359832635983,0.31320980274955496
2397,46,229,183,0,0,7.611353711790393,0.3000459664444941
2398,32,233,201,0,0,7.622317596566524,0.25329288145626533
2399,200,236,36,0,0,8.461864406779661,0.3091777857915657
2400,7,243,236,0,0,7.185185185185185,0.3085399449035788
2401,242,242,0,0,0,10.702479338842975,0.2596618771646993
2402,0,228,228,0,0,6.342105263157895,0.2965453280779078
2403,0,242,242,0,0,6.582644628099174,0.2773738897842983
2404,24,242,218,0,0,7.446280991735537,0.2813346593052358
2405,246,246,0,0,0,9.674796747967479,0.2856479177036595
2406,75,235,160,0,0,7.808510638297872,0.2836879432624122
2407,1,232,231,0,0,6.732758620689655,0.27459322286908683
2408,0,241,241,0,0,6.394190871369295,0.28146611341632405
2409,231,231,0,0,0,10.948051948051948,0.24946357989835594
2410,54,243,189,0,0,7.68724279835391,0.25715063088800666
2411,243,243,0,0,0,9.452674897119342,0.26531306329286225
2412,0,242,242,0,0,5.979338842975206,0.285878399231852
2413,216,239,23,0,0,8.523012552301255,0.25892197883337503
2414,142,229,87,0,0,8.126637554585153,0.2514364513904822
2415,15,242,227,0,0,7.371900826446281,0.25115736771715313
2416,114,234,120,0,0,7.987179487179487,0.2187190491911546
2417,241,241,0,0,0,9.846473029045644,0.2721645919778742
2418,23,229,206,0,0,7.497816593886463,0.30372328200414095
2419,6,238,232,0,0,7.176470588235294,0.2640853809878359
2420,52,229,177,0,0,7.633187772925764,0.2859112847621266
2421,122,239,117,0,0,7.99581589958159,0.34031855419992196
2422,0,232,232,0,0,6.163793103448276,0.2934020002985523
2423,76,243,167,0,0,7.773662551440329,0.2750059517736288
2424,0,234,234,0,0,6.461538461538462,0.29250577748431644
2425,4,244,240,0,0,7.139344262295082,0.2685691155636533
2426,234,234,0,0,0,9.217948717948717,0.2913502806206741
2427,217,242,25,0,0,8.508264462809917,0.2675662700181812
2428,153,236,83,0,0,8.173728813559322,0.280328164442843
2429,137,228,91,0,0,8.135964912280702,0.3118285802612235
2430,0,235,235,0,0,6.706382978723404,0.2595744680851038
2431,2,231,229,0,0,7.034632034632034,0.294447581404102
2432,94,230,136,0,0,7.921739130434783,0.2558572242263176
2433,0,239,239,0,0,6.2677824267782425,0.29773917935375066
2434,0,237,237,0,0,6.320675105485232,0.2526639490810247
2435,0,235,235,0,0,6.4425531914893615,0.2733951627568685
2436,0,229,229,0,0,6.820960698689956,0.2704359151153017
2437,53,243,190,0,0,7.654320987654321,0.31802877257422935
2438,0,228,228,0,0,6.600877192982456,0.27612257516036437
2439,1,235,234,0,0,6.872340425531915,0.2485906528459715
2440,6,235,229,0,0,7.23404255319149,0.27404982724131427
2441,49,229,180,0,0,7.681222707423581,0.2970581475522905
2442,247,247,0,0,0,9.878542510121457,0.22096046871399258
2443,0,242,242,0,0,6.012396694214876,0.31934775899317475
2444,37,231,194,0,0,7.541125541125541,0.29286655373611925
2445,14,230,216,0,0,7.395652173913043,0.28382380861970824
2446,8,227,219,0,0,7.330396475770925,0.27531090405832037
2447,61,227,166,0,0,7.691629955947136,0.32926591555884943
2448,241,241,0,0,0,9.780082987551868,0.2889349930843764
2449,247,247,0,0,0,10.37246963562753,0.28346664033442054
2450,0,244,244,0,0,7.036885245901639,0.2908149497402687
2451,0,240,240,0,0,5.991666666666666,0.27608089260809027
2452,0,242,242,0,0,6.487603305785124,0.2757792942628843
2453,244,244,0,0,0,10.221311475409836,0.32942049517640887
2454,43,239,196,0,0,7.661087866108787,0.26700889560844887
2455,109,231,122,0,0,7.891774891774892,0.2969320534537948
2456,64,245,181,0,0,7.779591836734694,0.2954834392773487
2457,0,228,228,0,0,6.201754385964913,0.2674858953551299
2458,0,239,239,0,0,6.0,0.2689075630252101
2459,0,243,243,0,0,6.7366255144032925,0.32704145835459186
2460,46,245,199,0,0,7.6,0.31475409836065277
2461,0,243,243,0,0,6.320987654320987,0.2601775329048079
2462,0,229,229,0,0,6.759825327510917,0.2797824254960512
2463,233,239,6,0,0,8.774058577405858,0.27646707218452066
2464,108,244,136,0,0,7.983606557377049,0.32071780341361716
2465,238,238,0,0,0,9.928571428571429,0.32820976491862347
2466,15,238,223,0,0,7.34453781512605,0.2521008403361332
2467,43,241,198,0,0,7.647302904564316,0.27091977869986295
2468,198,245,47,0,0,8.30204081632653,0.24446303111407822
2469,87,231,144,0,0,7.8311688311688314,0.2887634105025427
2470,0,229,229,0,0,6.222707423580786,0.24404351490079135
2471,0,233,233,0,0,6.360515021459228,0.28326180257510775
2472,0,226,226,0,0,6.761061946902655,0.280432645034412
2473,0,232,232,0,0,5.969827586206897,0.2718129571577812
2474,237,237,0,0,0,8.974683544303797,0.2620682257026401
2475,173,232,59,0,0,8.366379310344827,0.2677825048514728
2476,0,233,233,0,0,6.669527896995708,0.2998002071925416
2477,33,229,196,0,0,7.585152838427947,0.26135754232743574
2478,0,241,241,0,0,6.734439834024896,0.27918395573997257
2479,0,230,230,0,0,6.334782608695652,0.2848110879058288
2480,156,240,84,0,0,8.208333333333334,0.24093444909344744
2481,151,234,83,0,0,8.158119658119658,0.33111404570631886
2482,0,232,232,0,0,6.120689655172414,0.27108523660247663
2483,54,228,174,0,0,7.758771929824562,0.2807597186799609
2484,28,233,205,0,0,7.515021459227468,0.27671303833061883
2485,0,234,234,0,0,6.358974358974359,0.29118520964014705
2486,241,244,3,0,0,8.885245901639344,0.26661269648519853
2487,8,235,227,0,0,7.327659574468085,0.2639752682305884
2488,0,233,233,0,0,6.648068669527897,0.2980242711262392
2489,115,234,119,0,0,8.008547008547009,0.23168629177212974
2490,235,235,0,0,0,10.012765957446808,0.35453718857974714
2491,235,235,0,0,0,9.480851063829787,0.27634115293689804
2492,232,232,0,0,0,9.344827586206897,0.2961636065084384
2493,0,239,239,0,0,6.158995815899582,0.3023452058647736
2494,219,241,22,0,0,8.568464730290456,0.29633471645920506
2495,125,232,107,0,0,8.0,0.30303030303030304
2496,15,235,220,0,0,7.4,0.2752136752136737
2497,0,233,233,0,0,6.914163090128755,0.337427852597306
2498,0,239,239,0,0,6.652719665271967,0.2780492950318179
2499,0,242,242,0,0,6.595041322314049,0.27516203148040413
2500,0,238,238,0,0,6.533613445378151,0.29211431408005906
2501,0,243,243,0,0,6.732510288065844,0.2628643335714033
2502,53,229,176,0,0,7.716157205240175,0.2567992032482962
2503,96,231,135,0,0,7.904761904761905,0.3039337474120064
2504,0,240,240,0,0,6.216666666666667,0.23737796373779738
2505,0,231,231,0,0,6.203463203463204,0.31929230190099867
2506,18,231,213,0,0,7.441558441558442,0.2824392998306038
2507,66,228,162,0,0,7.7894736842105265,0.2902851843264536
2508,240,240,0,0,0,10.316666666666666,0.292608089260813
2509,3,234,231,0,0,7.14957264957265,0.2650856534976697
2510,233,238,5,0,0,8.6890756302521,0.299542601850862
2511,130,235,105,0,0,8.05531914893617,0.26615748317875937
2512,0,244,244,0,0,6.590163934426229,0.27578762733589984
2513,13,240,227,0,0,7.395833333333333,0.29872733612273616
2514,0,244,244,0,0,6.631147540983607,0.2666801592120374
2515,22,239,217,0,0,7.397489539748954,0.2741113181674344
2516,235,235,0,0,0,10.693617021276596,0.2647026732133043
2517,4,232,228,0,0,7.211206896551724,0.2712158531124051
2518,4,226,222,0,0,7.053097345132743,0.3349459193706975
2519,16,229,213,0,0,7.497816593886463,0.26863556270589534
2520,38,243,205,0,0,7.580246913580247,0.2776247321701831
2521,243,243,0,0,0,9.551440329218106,0.26490494167261536
2522,0,237,237,0,0,6.1265822784810124,0.29746835443037817
2523,245,245,0,0,0,9.648979591836735,0.26152559384409557
2524,36,229,193,0,0,7.633187772925764,0.2683674251130038
2525,0,238,238,0,0,6.1344537815126055,0.31095982696876223
2526,230,246,16,0,0,8.695121951219512,0.2536087605774068
2527,2,226,224,0,0,7.185840707964601,0.30308751229105435
2528,241,241,0,0,0,10.659751037344398,0.25874827109267545
2529,3,243,240,0,0,7.053497942386831,0.30704349896268845
2530,245,245,0,0,0,10.212244897959184,0.2990297758447685
2531,49,243,194,0,0,7.691358024691358,0.2638506274869925
2532,26,229,203,0,0,7.5895196506550215,0.26936336474373573
2533,0,239,239,0,0,6.510460251046025,0.3013607116486777
2534,0,234,234,0,0,6.128205128205129,0.29250577748431644
2535,8,237,229,0,0,7.198312236286919,0.26982764785811075
2536,57,234,177,0,0,7.6923076923076925,0.27401782766589816
2537,137,246,109,0,0,8.0,0.2530612244897959
2538,0,233,233,0,0,6.600858369098712,0.24948201864732913
2539,242,242,0,0,0,10.40495867768595,0.30005829704057013
2540,85,228,143,0,0,7.828947368421052,0.30981915140273886
2541,1,226,225,0,0,7.154867256637168,0.2470206489675507
2542,109,237,128,0,0,7.924050632911392,0.2569191160695158
2543,0,227,227,0,0,6.325991189427313,0.2737904954972498
2544,0,229,229,0,0,6.096069868995633,0.2714318547460336
2545,214,229,15,0,0,8.576419213973798,0.297862560330957
2546,89,240,151,0,0,7.916666666666667,0.2691771269177152
2547,45,236,191,0,0,7.6525423728813555,0.2702488279841302
2548,0,231,231,0,0,6.5021645021645025,0.31195181629963886
2549,0,226,226,0,0,6.154867256637168,0.2825762045231062
2550,0,241,241,0,0,6.991701244813278,0.24993084370677632
2551,56,243,187,0,0,7.683127572016461,0.2504166241540002
2552,242,242,0,0,0,10.524793388429751,0.27531634717601855
2553,230,230,0,0,0,9.495652173913044,0.2860072147332374
2554,25,243,218,0,0,7.530864197530864,0.25834098561371177
2555,133,231,98,0,0,8.086580086580087,0.3142104272539022
2556,7,242,235,0,0,7.095041322314049,0.3021329858372506
2557,221,230,9,0,0,8.71304347826087,0.26664135181318355
2558,242,242,0,0,0,10.524793388429751,0.25871883680257457
2559,0,238,238,0,0,7.130252100840337,0.2909796830124465
2560,0,231,231,0,0,6.523809523809524,0.30269151138716394
2561,1,228,227,0,0,6.767543859649122,0.258501429785915
2562,241,241,0,0,0,9.323651452282158,0.3031466113416324
2563,40,231,191,0,0,7.558441558441558,0.27374364765669074
2564,6,243,237,0,0,7.156378600823046,0.23990749243274734
2565,4,232,228,0,0,7.081896551724138,0.2573331840573201
2566,231,231,0,0,0,10.212121212121213,0.25480895915678287
2567,1,240,239,0,0,6.8875,0.29273012552301103
2568,12,236,224,0,0,7.364406779661017,0.26664262531554184
2569,0,233,233,0,0,6.369098712446352,0.26835133935178573
2570,21,230,209,0,0,7.434782608695652,0.325422441617616
2571,192,239,47,0,0,8.355648535564853,0.24693224570162922
2572,243,244,1,0,0,9.23360655737705,0.2291540174053867
2573,0,228,228,0,0,6.754385964912281,0.2653991807713118
2574,0,243,243,0,0,6.090534979423868,0.2975546712920454
2575,75,243,168,0,0,7.814814814814815,0.27548209366390936
2576,0,238,238,0,0,6.42436974789916,0.29594369393326597
2577,237,237,0,0,0,10.582278481012658,0.24426088822141445
2578,1,244,243,0,0,6.770491803278689,0.3174795925251264
2579,0,230,230,0,0,6.239130434782608,0.278811467628629
2580,17,245,228,0,0,7.281632653061225,0.3178989628638311
2581,238,244,6,0,0,8.90983606557377,0.26344194832355416
2582,239,239,0,0,0,9.389121338912133,0.27231813227382273
2583,0,237,237,0,0,5.9789029535864975,0.2241292998641241
2584,95,232,137,0,0,7.935344827586207,0.2771868935662055
2585,3,243,240,0,0,7.032921810699588,0.27990341121653917
2586,238,238,0,0,0,10.794117647058824,0.22325639116405516
2587,235,235,0,0,0,9.863829787234042,0.31471176577559895
2588,235,235,0,0,0,10.246808510638298,0.2721585742862313
2589,35,240,205,0,0,7.566666666666666,0.28005578800557523
2590,0,238,238,0,0,6.323529411764706,0.27041449491188657
2591,224,235,11,0,0,8.731914893617022,0.2568830696490272
2592,0,232,232,0,0,6.517241379310345,0.2940737423496063
2593,0,236,236,0,0,6.572033898305085,0.2713847818247388
2594,0,229,229,0,0,6.676855895196507,0.2986286677392184
2595,243,243,0,0,0,9.765432098765432,0.28772574227120407
2596,3,240,237,0,0,7.079166666666667,0.24893654114365057
2597,0,232,232,0,0,5.978448275862069,0.27226078519181723
2598,1,240,239,0,0,6.720833333333333,0.2941248256624836
2599,0,227,227,0,0,6.775330396475771,0.26345951424895875
2600,71,232,161,0,0,7.741379310344827,0.2704881325571005
2601,0,233,233,0,0,6.635193133047211,0.2585836909871228
2602,1,239,238,0,0,6.841004184100418,0.2771351218311602
2603,0,233,233,0,0,6.278969957081545,0.25373686547284485
2604,6,234,228,0,0,7.1581196581196584,0.26244451780932315
2605,235,240,5,0,0,8.775,0.26715481171547506
2606,115,231,116,0,0,7.922077922077922,0.24607566346696885
2607,16,244,228,0,0,7.352459016393443,0.3032449571611649
2608,236,236,0,0,0,10.279661016949152,0.27890371438874395
2609,235,235,0,0,0,10.787234042553191,0.30496453900708825
2610,82,229,147,0,0,7.860262008733624,0.30494905385735127
2611,94,232,138,0,0,7.918103448275862,0.30928123600537205
2612,23,230,207,0,0,7.460869565217391,0.2932219479779788
2613,122,239,117,0,0,7.958158995815899,0.275552898983863
2614,170,237,67,0,0,8.248945147679326,0.3064077808767791
2615,242,242,0,0,0,10.789256198347108,0.2583073282809261
2616,0,243,243,0,0,6.127572016460905,0.26878209706492345
2617,0,233,233,0,0,6.618025751072961,0.28881160278229673
2618,0,229,229,0,0,6.096069868995633,0.21880027579866515
2619,230,230,0,0,0,10.443478260869565,0.2828175431934706
2620,2,242,240,0,0,6.884297520661157,0.3019100853880181
2621,2,230,228,0,0,6.982608695652174,0.2529713309284243
2622,77,230,153,0,0,7.808695652173913,0.31258781089804055
2623,0,241,241,0,0,6.224066390041494,0.2829183955739988
2624,0,236,236,0,0,6.190677966101695,0.22306166606562947
2625,0,241,241,0,0,6.066390041493776,0.21224066390041116
2626,230,230,0,0,0,10.2,0.2742358078602588
2627,83,235,152,0,0,7.85531914893617,0.26957628659755967
2628,0,235,235,0,0,6.2042553191489365,0.30852882342244414
2629,91,241,150,0,0,7.912863070539419,0.25487551867220193
2630,9,241,232,0,0,7.16597510373444,0.3140041493775925
2631,0,243,243,0,0,6.51440329218107,0.27561813420399167
2632,237,237,0,0,0,9.818565400843882,0.3101623399842677
2633,51,237,186,0,0,7.658227848101266,0.242866337695771
2634,9,233,224,0,0,7.184549356223176,0.2804499038034637
2635,242,242,0,0,0,10.429752066115702,0.3124721374438516
2636,0,243,243,0,0,6.382716049382716,0.27854300581573116
2637,127,235,108,0,0,8.008510638297873,0.23924349881796927
2638,236,237,1,0,0,9.130801687763713,0.2836658799971424
2639,3,241,238,0,0,7.004149377593361,0.25414937759336076
2640,0,243,243,0,0,6.226337448559671,0.2915348773934635
2641,0,230,230,0,0,6.021739130434782,0.27463451680273365
2642,131,240,109,0,0,8.091666666666667,0.23423988842398985
2643,118,230,112,0,0,8.02608695652174,0.261325232580215
2644,101,242,141,0,0,7.913223140495868,0.22895305373615532
2645,239,239,0,0,0,9.359832635983263,0.2733377869976453
2646,117,232,115,0,0,8.02155172413793,0.3155508284818605
2647,2,243,241,0,0,6.79835390946502,0.3021460395197781
2648,246,246,0,0,0,10.772357723577235,0.26633482661357505
2649,155,232,77,0,0,8.193965517241379,0.3128638602776523
2650,0,226,226,0,0,6.314159292035399,0.23419862340216543
2651,105,233,128,0,0,7.987124463519313,0.2713852301317118
2652,77,229,152,0,0,7.851528384279476,0.2585612502872895
2653,96,238,142,0,0,7.873949579831932,0.2878417189660644
2654,0,234,234,0,0,6.6239316239316235,0.27856645024026805
2655,233,233,0,0,0,10.88412017167382,0.25806570963445197
2656,26,236,210,0,0,7.377118644067797,0.28696357735304656
2657,0,236,236,0,0,6.779661016949152,0.24911648034619846
2658,66,236,170,0,0,7.809322033898305,0.24008294266137417
2659,19,231,212,0,0,7.411255411255412,0.277959721437986
2660,60,242,182,0,0,7.681818181818182,0.27593360995850624
2661,4,238,234,0,0,7.071428571428571,0.32820976491862347
2662,0,237,237,0,0,6.641350210970464,0.26489308445969967
2663,241,241,0,0,0,10.46058091286307,0.27448132780082235
2664,1,244,243,0,0,6.922131147540983,0.28609255886123286
2665,6,235,229,0,0,7.238297872340426,0.2421167484997288
2666,0,240,240,0,0,6.308333333333334,0.2727336122733577
2667,0,233,233,0,0,6.055793991416309,0.2511839573775323
2668,0,233,233,0,0,6.244635193133047,0.2976542844457589
2669,207,245,38,0,0,8.46938775510204,0.27467380394780955
2670,26,230,204,0,0,7.521739130434782,0.3030187962787162
2671,0,228,228,0,0,6.899122807017544,0.258501429785915
2672,238,238,0,0,0,9.743697478991596,0.31799808531007173
2673,0,226,226,0,0,6.088495575221239,0.24991150442477697
2674,234,234,0,0,0,9.585470085470085,0.2952386192729515
2675,21,233,212,0,0,7.454935622317596,0.2835207932514393
2676,5,235,230,0,0,7.31063829787234,0.30052736861247636
2677,29,228,199,0,0,7.552631578947368,0.37166705309529374
2678,51,244,193,0,0,7.651639344262295,0.26086149902179306
2679,0,244,244,0,0,5.991803278688525,0.29622883356944996
2680,239,239,0,0,0,9.351464435146443,0.2625083506205831
2681,0,234,234,0,0,6.435897435897436,0.27269725982172094
2682,0,231,231,0,0,6.4935064935064934,0.2945228684359118
2683,221,237,16,0,0,8.624472573839663,0.26092397911749793
2684,0,228,228,0,0,6.671052631578948,0.3010085787155142
2685,195,231,36,0,0,8.463203463203463,0.2932053453792595
2686,231,231,0,0,0,9.545454545454545,0.26640316205533887
2687,0,242,242,0,0,6.421487603305785,0.27804259113198826
2688,6,237,231,0,0,7.244725738396625,0.3042623185296395
2689,239,239,0,0,0,9.94142259414226,0.3158820013361052
2690,0,234,234,0,0,6.3931623931623935,0.28252815377279183
2691,119,241,122,0,0,7.979253112033195,0.3037344398340262
2692,72,227,155,0,0,7.8370044052863435,0.2520759424583812
2693,23,236,213,0,0,7.495762711864407,0.26806707536963315
2694,232,232,0,0,0,10.745689655172415,0.25972160023884816
2695,0,239,239,0,0,6.355648535564853,0.25533560704616703
2696,39,232,193,0,0,7.581896551724138,0.2789782057023417
2697,243,243,0,0,0,10.481481481481481,0.31680440771350366
2698,114,229,115,0,0,7.96943231441048,0.2666053780740026
2699,233,233,0,0,0,10.69098712446352,0.2575477282817889
2700,244,244,0,0,0,9.975409836065573,0.2545368683802234
2701,120,238,118,0,0,7.987394957983193,0.2403467716200414
2702,238,238,0,0,0,9.655462184873949,0.2689784774669426
2703,2,235,233,0,0,6.868085106382979,0.268848881614836
2704,0,228,228,0,0,6.526315789473684,0.2768374681196404
2705,0,244,244,0,0,6.118852459016393,0.25330567361532963
2706,0,231,231,0,0,5.9437229437229435,0.28812347073216704
2707,74,245,171,0,0,7.7877551020408164,0.299029775844761
2708,26,241,215,0,0,7.473029045643154,0.300311203319499
2709,243,243,0,0,0,9.473251028806585,0.28337244498860037
2710,1,234,233,0,0,6.923076923076923,0.3116540112248273
2711,2,238,236,0,0,7.130252100840337,0.3078573201432481
2712,117,237,120,0,0,8.004219409282701,0.24150754487592335
2713,1,238,237,0,0,6.5,0.29324894514767935
2714,216,238,22,0,0,8.483193277310924,0.2845264688153811
2715,0,242,242,0,0,6.132231404958677,0.3392887761050686
2716,0,238,238,0,0,6.483193277310924,0.2676488316845717
2717,242,242,0,0,0,9.698347107438016,0.2613250574397314
2718,0,244,244,0,0,6.508196721311475,0.30857451258179563
2719,234,239,5,0,0,8.916317991631798,0.2534721001371325
2720,1,236,235,0,0,7.088983050847458,0.24311215290298935
2721,230,230,0,0,0,9.160869565217391,0.3189861401177152
2722,0,235,235,0,0,6.5574468085106385,0.281942171303877
2723,0,238,238,0,0,6.147058823529412,0.2947381484239252
2724,37,239,202,0,0,7.619246861924686,0.29559438838297114
2725,64,242,178,0,0,7.6652892561983474,0.2982922396351259
2726,0,231,231,0,0,6.748917748917749,0.2671183888575204
2727,1,243,242,0,0,6.79835390946502,0.25255926266027395
2728,0,239,239,0,0,6.054393305439331,0.27854154213986965
2729,62,235,173,0,0,7.736170212765957,0.32325877432260747
2730,0,230,230,0,0,6.065217391304348,0.30577178659578197
2731,230,231,1,0,0,9.316017316017316,0.27795972143797804
2732,2,238,236,0,0,6.915966386554622,0.34733893557423173
2733,234,234,0,0,0,9.264957264957266,0.28142768056930695
2734,241,241,0,0,0,10.680497925311203,0.2683264177040049
2735,237,237,0,0,0,9.345991561181435,0.278087677894584
2736,233,234,1,0,0,9.487179487179487,0.30241003631561814
2737,240,240,0,0,0,10.220833333333333,0.28994072524407355
2738,180,245,65,0,0,8.273469387755101,0.3142522582803678
2739,1,230,229,0,0,6.478260869565218,0.28555154737041927
2740,241,245,4,0,0,8.80408163265306,0.2729340916694575
2741,0,227,227,0,0,6.101321585903084,0.33924603329305036
2742,19,234,215,0,0,7.418803418803419,0.30453761784234157
2743,147,234,87,0,0,8.106837606837606,0.23317193059682617
2744,0,228,228,0,0,6.232456140350878,0.2937437205348137
2745,245,245,0,0,0,9.518367346938776,0.2834727333556359
2746,2,240,238,0,0,6.9,0.29958158995816053
2747,0,238,238,0,0,6.033613445378151,0.2773463815906076
2748,136,230,94,0,0,8.143478260869566,0.2981013859882304
2749,9,240,231,0,0,7.183333333333334,0.2842398884239853
2750,1,238,237,0,0,6.773109243697479,0.26897847746693493
2751,0,233,233,0,0,6.120171673819742,0.22687583247002766
2752,238,240,2,0,0,8.8625,0.21114016736402283
2753,0,236,236,0,0,6.805084745762712,0.2597187161918478
2754,78,242,164,0,0,7.7727272727272725,0.25103734439834025
2755,0,239,239,0,0,6.2887029288702925,0.29865335255440834
2756,23,235,212,0,0,7.502127659574468,0.3194398981632987
2757,8,236,228,0,0,7.1991525423728815,0.3133609808871273
2758,0,243,243,0,0,6.061728395061729,0.29782675237220996
2759,0,227,227,0,0,6.022026431718062,0.2959728665549106
2760,227,229,2,0,0,8.943231441048034,0.2555351260246728
2761,0,228,228,0,0,6.578947368421052,0.27127289589613096
2762,233,233,0,0,0,10.334763948497853,0.25813970697055116
2763,231,231,0,0,0,9.173160173160174,0.2742330133634507
2764,99,232,133,0,0,7.9094827586206895,0.23852440662785462
2765,1,228,227,0,0,6.592105263157895,0.3306862972409034
2766,234,240,6,0,0,8.779166666666667,0.28157252440725344
2767,109,227,118,0,0,7.973568281938326,0.25593544111340466
2768,0,237,237,0,0,6.30379746835443,0.2717228062647491
2769,0,242,242,0,0,6.367768595041323,0.27497342340797315
2770,0,242,242,0,0,6.6652892561983474,0.30659099482184793
2771,38,242,204,0,0,7.619834710743802,0.2864099310723208
2772,0,235,235,0,0,6.259574468085106,0.28703400618294245
2773,17,240,223,0,0,7.416666666666667,0.2691771269177152
2774,247,247,0,0,0,10.109311740890687,0.2603600934794744
2775,133,233,100,0,0,8.120171673819742,0.31308272902175177
2776,242,244,2,0,0,9.073770491803279,0.266140457397289
2777,6,235,229,0,0,7.25531914893617,0.3020549190761937
2778,31,236,205,0,0,7.601694915254237,0.291741795888927
2779,66,237,171,0,0,7.7594936708860756,0.2681827933919737
2780,0,230,230,0,0,5.965217391304348,0.269527245111069
2781,4,244,240,0,0,7.073770491803279,0.25791000472239184
2782,2,240,238,0,0,6.729166666666667,0.2317817294281755
2783,245,245,0,0,0,10.114285714285714,0.2655737704918003
2784,109,229,120,0,0,8.034934497816593,0.35842335095380723
2785,233,233,0,0,0,10.738197424892704,0.26306052982092043
2786,39,243,204,0,0,7.592592592592593,0.2837465564738267
2787,64,233,169,0,0,7.71244635193133,0.27471511025603457
2788,7,235,228,0,0,7.23404255319149,0.27404982724131427
2789,247,247,0,0,0,9.615384615384615,0.25390869293308543
2790,216,238,22,0,0,8.521008403361344,0.2928057298868916
2791,57,230,173,0,0,7.721739130434782,0.28904499715207543
2792,0,230,230,0,0,6.282608695652174,0.25602809948737143
2793,19,242,223,0,0,7.475206611570248,0.2753163471760261
2794,153,232,79,0,0,8.202586206896552,0.30943051201672
2795,139,233,94,0,0,8.103004291845494,0.308309900843573
2796,0,231,231,0,0,6.554112554112554,0.3090156220591029
2797,0,227,227,0,0,6.008810572687224,0.3185061011266615
2798,0,229,229,0,0,6.253275109170306,0.2601317704742174
2799,92,229,137,0,0,7.908296943231441,0.2766413851221953
2800,129,245,116,0,0,8.024489795918367,0.2862830378052884
2801,28,232,204,0,0,7.538793103448276,0.2842028660994181
2802,233,244,11,0,0,8.64344262295082,0.3044424205626355
2803,91,237,146,0,0,7.9071729957805905,0.25405849960666815
2804,0,231,231,0,0,6.748917748917749,0.2671183888575204
2805,234,236,2,0,0,8.923728813559322,0.3005409304002898
2806,0,236,236,0,0,6.716101694915254,0.2722502704652025
2807,205,233,28,0,0,8.429184549356224,0.27190321148439045
2808,58,228,170,0,0,7.741228070175438,0.2631385733055116
2809,35,238,203,0,0,7.554621848739496,0.27337517285395196
2810,239,239,0,0,0,9.443514644351465,0.2646531415913702
2811,1,231,230,0,0,6.411255411255412,0.2692640692640729
2812,6,235,229,0,0,7.191489361702128,0.2836879432624122
2813,122,245,123,0,0,7.9918367346938775,0.22944128471060332
2814,2,229,227,0,0,7.074235807860262,0.27955259327358073
2815,201,240,39,0,0,8.416666666666666,0.2691771269177076
2816,140,243,103,0,0,8.090534979423868,0.2975546712920454
2817,97,234,137,0,0,7.884615384615385,0.29993397160779073
2818,0,245,245,0,0,6.8040816326530615,0.2811308129809329
2819,6,238,232,0,0,7.2100840336134455,0.2847923979718445
2820,105,236,131,0,0,7.936440677966102,0.25551749008294056
2821,76,241,165,0,0,7.742738589211618,0.2668741355463377
2822,229,229,0,0,0,10.030567685589519,0.22274572895119554
2823,86,242,156,0,0,7.900826446280992,0.2722814718288125
2824,22,234,212,0,0,7.461538461538462,0.2753383955100675
2825,229,229,0,0,0,10.471615720524017,0.2766030797517822
2826,0,243,243,0,0,6.68724279835391,0.265415093697924
2827,0,231,231,0,0,6.5064935064935066,0.26843591191417265
2828,0,230,230,0,0,6.660869565217391,0.2775014239605099
2829,0,234,234,0,0,6.5085470085470085,0.2681669784674087
2830,14,235,221,0,0,7.302127659574468,0.3228587015821068
2831,116,235,119,0,0,7.948936170212766,0.2965266412074925
2832,0,238,238,0,0,6.4411764705882355,0.24758004467610145
2833,2,236,234,0,0,7.0508474576271185,0.26974395961053155
2834,14,235,221,0,0,7.378723404255319,0.3132205855610089
2835,235,235,0,0,0,10.885106382978723,0.2816148390616463
2836,0,242,242,0,0,6.8264462809917354,0.251911800006862
2837,90,243,153,0,0,7.8353909465020575,0.262048090330917
2838,0,240,240,0,0,6.133333333333334,0.24156206415620743
2839,38,228,190,0,0,7.578947368421052,0.2800834685833556
2840,240,240,0,0,0,9.995833333333334,0.24684449093445315
2841,0,229,229,0,0,6.275109170305677,0.27924615031027616
2842,1,228,227,0,0,7.026315789473684,0.25481103640157876
2843,49,242,193,0,0,7.714876033057851,0.27106409245224544
2844,0,230,230,0,0,6.282608695652174,0.28222897284981685
2845,0,233,233,0,0,6.429184549356223,0.31500665976025255
2846,235,235,0,0,0,10.846808510638297,0.2584833606110145
2847,245,245,0,0,0,10.608163265306123,0.2966543994647002
2848,0,243,243,0,0,6.255144032921811,0.2900044213175526
2849,0,232,232,0,0,6.224137931034483,0.2785490371697252
2850,0,239,239,0,0,6.878661087866109,0.26672761154671154
2851,0,243,243,0,0,6.288065843621399,0.32163384688637287
2852,0,228,228,0,0,6.899122807017544,0.27612257516036437
2853,238,239,1,0,0,8.895397489539748,0.32934847579199106
2854,24,229,205,0,0,7.541484716157205,0.2756837508618685
2855,19,236,217,0,0,7.432203389830509,0.2975117201586746
2856,1,242,241,0,0,6.789256198347108,0.29150234902781413
2857,152,242,90,0,0,8.115702479338843,0.27701381982785217
2858,184,242,58,0,0,8.239669421487603,0.26597167449675213
2859,0,242,242,0,0,6.8264462809917354,0.251911800006862
2860,8,240,232,0,0,7.229166666666667,0.27780683403068596
2861,0,231,231,0,0,6.861471861471862,0.26768304159608225
2862,101,238,137,0,0,7.8655462184873945,0.31095982696876223
2863,241,241,0,0,0,10.340248962655602,0.3170816044260088
2864,0,230,230,0,0,6.243478260869566,0.2898044427567909
2865,235,235,0,0,0,10.046808510638298,0.2584833606110145
2866,0,229,229,0,0,6.759825327510917,0.2622385658469284
2867,0,235,235,0,0,6.187234042553191,0.2895799236224791
2868,21,240,219,0,0,7.475,0.27552301255230277
2869,0,230,230,0,0,6.247826086956522,0.28329219669641376
2870,0,242,242,0,0,6.099173553719008,0.2722814718288125
2871,0,238,238,0,0,6.798319327731092,0.2545119313548225
2872,16,243,227,0,0,7.37037037037037,0.2424242424242399
2873,0,226,226,0,0,6.3053097345132745,0.3019272369714842
2874,24,245,221,0,0,7.526530612244898,0.26671127467380146
2875,238,238,0,0,0,9.012605042016807,0.23190795305463288
2876,122,231,109,0,0,8.030303030303031,0.20342555994729597
2877,0,237,237,0,0,6.215189873417722,0.27976829006650916
2878,237,237,0,0,0,10.109704641350211,0.25062575985124935
2879,0,232,232,0,0,6.133620689655173,0.2807695178384858
2880,0,239,239,0,0,6.426778242677824,0.262473190112864
2881,0,225,225,0,0,6.315555555555555,0.28837301587301617
2882,7,234,227,0,0,7.303418803418803,0.2723487766406248
2883,0,239,239,0,0,6.539748953974895,0.2830772476354545
2884,245,245,0,0,0,9.583673469387755,0.2849782535965206
2885,237,237,0,0,0,10.50632911392405,0.31881570478438687
2886,245,245,0,0,0,10.363265306122448,0.25684175309467466
2887,196,230,34,0,0,8.434782608695652,0.26428707043857674
2888,0,238,238,0,0,6.69327731092437,0.30636811686700227
2889,196,230,34,0,0,8.491304347826087,0.30341750522119104
2890,27,231,204,0,0,7.515151515151516,0.2943346508563912
2891,0,234,234,0,0,6.085470085470085,0.2845090055390459
2892,0,236,236,0,0,6.02542372881356,0.2887125856473118
2893,94,244,150,0,0,7.852459016393443,0.24974701477433361
2894,117,235,118,0,0,8.02127659574468,0.26022913256955743
2895,0,228,228,0,0,6.162280701754386,0.2863242909034704
2896,1,239,238,0,0,6.707112970711297,0.2836046552512253
2897,205,238,33,0,0,8.457983193277311,0.2745984469737267
2898,233,236,3,0,0,9.09322033898305,0.28914532996754366
2899,2,239,237,0,0,7.01673640167364,0.29383636299707855
2900,68,238,170,0,0,7.802521008403361,0.24353792149770997
2901,0,245,245,0,0,6.575510204081633,0.2862830378052884
2902,0,239,239,0,0,6.376569037656904,0.2861713723146184
2903,43,238,195,0,0,7.579831932773109,0.2699712796510988
2904,28,239,211,0,0,7.527196652719665,0.2839210998206817
2905,232,232,0,0,0,10.133620689655173,0.2807695178384779
2906,1,232,231,0,0,6.948275862068965,0.23973727422003419
2907,0,243,243,0,0,5.995884773662551,0.26031357344489015
2908,0,236,236,0,0,6.228813559322034,0.24529390551748642
2909,3,229,226,0,0,6.9825327510917035,0.25407952194897615
2910,0,240,240,0,0,6.295833333333333,0.25939679218967565
2911,0,237,237,0,0,5.991561181434599,0.26264034899521116
2912,203,241,38,0,0,8.360995850622407,0.2649723374827166
2913,17,232,215,0,0,7.375,0.24404761904761904
2914,0,233,233,0,0,6.420600858369099,0.2706082581027094
2915,0,235,235,0,0,6.685106382978724,0.25939261683942877
2916,51,244,193,0,0,7.709016393442623,0.2565438845038129
2917,230,230,0,0,0,10.878260869565217,0.29079172204290354
2918,238,238,0,0,0,9.260504201680673,0.2778427826826972
2919,5,241,236,0,0,7.091286307053942,0.2832987551867215
2920,224,230,6,0,0,8.839130434782609,0.22291627112208198
2921,131,241,110,0,0,8.053941908713693,0.2595781466113446
2922,234,234,0,0,0,10.183760683760683,0.29655918711712087
2923,0,240,240,0,0,6.325,0.303974895397488
2924,0,236,236,0,0,6.2076271186440675,0.28436711143166327
2925,0,237,237,0,0,6.075949367088608,0.23149538725595648
2926,14,238,224,0,0,7.34453781512605,0.2605396589015341
2927,1,232,231,0,0,6.956896551724138,0.27519032691446293
2928,14,243,229,0,0,7.308641975308642,0.2886440159167446
2929,0,226,226,0,0,6.787610619469026,0.2835791543756123
2930,0,244,244,0,0,6.418032786885246,0.31012615529919463
2931,37,245,208,0,0,7.636734693877551,0.28143191702910836
2932,123,234,111,0,0,7.9914529914529915,0.2660210557206276
2933,5,233,228,0,0,7.094420600858369,0.29277046026343134
2934,24,231,207,0,0,7.441558441558442,0.27374364765669074
2935,13,243,230,0,0,7.300411522633745,0.29367751589973723
2936,199,229,30,0,0,8.493449781659388,0.2685972573354823
2937,0,226,226,0,0,6.035398230088496,0.27429695181907543
2938,65,241,176,0,0,7.721991701244813,0.2598893499308436
2939,243,243,0,0,0,9.518518518518519,0.29201101928375156
2940,3,244,241,0,0,7.057377049180328,0.3094515280307609
2941,22,231,209,0,0,7.458874458874459,0.2667795972143801
2942,58,237,179,0,0,7.70464135021097,0.259851247943932
2943,4,238,234,0,0,7.046218487394958,0.28899407864411863
2944,8,232,224,0,0,7.232758620689655,0.29190924018510417
2945,129,236,107,0,0,8.038135593220339,0.24960331770645156
2946,238,238,0,0,0,10.8109243697479,0.27211644151330927
2947,0,236,236,0,0,6.9491525423728815,0.21016949152542516
2948,0,228,228,0,0,6.723684210526316,0.28014143287734966
2949,11,243,232,0,0,7.230452674897119,0.3103084719246337
2950,2,242,240,0,0,7.06198347107438,0.26585165117794685
2951,209,243,34,0,0,8.419753086419753,0.28588919498010795
2952,3,236,233,0,0,7.033898305084746,0.30522899386945784
2953,240,240,0,0,0,9.316666666666666,0.25913528591353263
2954,244,244,0,0,0,9.397540983606557,0.2981009242393617
2955,0,226,226,0,0,6.066371681415929,0.2577974434611598
2956,0,238,238,0,0,6.7100840336134455,0.24048860050349008
2957,0,232,232,0,0,6.633620689655173,0.25912449619346417
2958,246,246,0,0,0,11.004065040650406,0.2489629998340744
2959,1,234,233,0,0,7.055555555555555,0.2930376728659973
2960,246,246,0,0,0,9.341463414634147,0.2747635639621728
2961,25,237,212,0,0,7.531645569620253,0.2754773653722376
2962,0,229,229,0,0,5.973799126637554,0.2975561173676564
2963,176,228,52,0,0,8.320175438596491,0.2802960043280005
2964,1,227,226,0,0,6.81057268722467,0.2781178121710654
2965,8,227,219,0,0,7.136563876651983,0.28657752134419584
2966,229,229,0,0,0,9.410480349344978,0.2956791542174279
2967,242,242,0,0,0,11.045454545454545,0.2842323651452282
2968,41,229,188,0,0,7.606986899563319,0.27468781123113667
2969,233,233,0,0,0,11.030042918454935,0.2361624981500615
2970,1,236,235,0,0,6.783898305084746,0.28076090876307486
2971,244,244,0,0,0,10.21311475409836,0.27538285097483667
2972,0,234,234,0,0,6.688034188034188,0.292817578225305
2973,231,231,0,0,0,10.558441558441558,0.2824392998306038
2974,0,237,237,0,0,6.2025316455696204,0.2554172924265158
2975,0,242,242,0,0,6.599173553719008,0.282654915812215
2976,234,234,0,0,0,10.316239316239317,0.29441326437033977
2977,237,237,0,0,0,10.0084388185654,0.30501323035113564
2978,0,228,228,0,0,6.030701754385965,0.1972911353273028
2979,0,231,231,0,0,6.7186147186147185,0.29873894221719915
2980,50,241,191,0,0,7.6846473029045645,0.30013831258644735
2981,4,235,231,0,0,7.208510638297873,0.26830332787779526
2982,41,238,197,0,0,7.621848739495798,0.2699003652093783
2983,0,238,238,0,0,6.966386554621849,0.26890756302520674
2984,1,237,236,0,0,6.949367088607595,0.2686118858614001
2985,8,237,229,0,0,7.194092827004219,0.3096259743974847
2986,3,241,238,0,0,7.244813278008299,0.2773167358229633
2987,37,246,209,0,0,7.565040650406504,0.30391571262651046
2988,86,231,145,0,0,7.8268398268398265,0.2568417090156246
2989,1,238,237,0,0,6.9411764705882355,0.28344502357905504
2990,3,226,223,0,0,6.849557522123894,0.2883775811209408
2991,242,242,0,0,0,10.921487603305785,0.2884160351153907
2992,234,234,0,0,0,9.055555555555555,0.250119217930375
2993,0,240,240,0,0,6.791666666666667,0.2827754532775479
2994,15,233,218,0,0,7.313304721030043,0.30227911795175494
2995,229,241,12,0,0,8.618257261410788,0.2786652835407949
2996,1,241,240,0,0,6.7053941908713695,0.2836791147994442
2997,239,239,0,0,0,11.00418410041841,0.31510847016631616
2998,49,231,182,0,0,7.675324675324675,0.3158667419536948
2999,237,237,0,0,0,10.0084388185654,0.2880640778087628
3000,96,230,134,0,0,7.917391304347826,0.25078792481488715
3001,244,244,0,0,0,10.610655737704919,0.29634689334143105
3002,239,239,0,0,0,10.518828451882845,0.27590450406104605
3003,241,241,0,0,0,10.136929460580912,0.2520055325034567
3004,1,235,234,0,0,6.582978723404255,0.3210765593744288
3005,28,231,203,0,0,7.471861471861472,0.2763786937699953
3006,240,240,0,0,0,10.683333333333334,0.2842398884239929
3007,0,225,225,0,0,6.235555555555556,0.2880158730158736
3008,0,238,238,0,0,6.5588235294117645,0.2560188632415023
3009,0,233,233,0,0,6.060085836909871,0.25499482018647635
3010,235,235,0,0,0,10.0,0.3504273504273504
3011,19,233,214,0,0,7.416309012875536,0.28714666272014316
3012,0,239,239,0,0,6.523012552301255,0.2673253401779129
3013,0,230,230,0,0,6.3652173913043475,0.2677805202202409
3014,234,234,0,0,0,9.341880341880342,0.2946333590110477
3015,0,241,241,0,0,6.1037344398340245,0.285027662517291
3016,3,227,224,0,0,7.220264317180617,0.25215391212817995
3017,5,232,227,0,0,7.077586206896552,0.2710105985968066
3018,244,244,0,0,0,9.889344262295081,0.3045773460163282
3019,237,237,0,0,0,10.535864978902953,0.2836658799971424
3020,2,244,242,0,0,6.938524590163935,0.22254267017472748
3021,43,240,197,0,0,7.6375,0.25716527196652567
3022,0,234,234,0,0,6.145299145299146,0.2706430431752283
3023,0,238,238,0,0,6.0210084033613445,0.24006311385313633
3024,235,237,2,0,0,8.919831223628693,0.24354573410569869
3025,245,245,0,0,0,10.420408163265305,0.27745065239211175
3026,191,235,44,0,0,8.395744680851063,0.2828877977814185
3027,107,231,124,0,0,7.909090909090909,0.3090909090909127
3028,3,239,236,0,0,7.179916317991632,0.24900671565697055
3029,238,238,0,0,0,9.714285714285714,0.2808921036769094
3030,80,240,160,0,0,7.720833333333333,0.3192294281729438
3031,0,230,230,0,0,6.339130434782609,0.2687677995063615
3032,0,236,236,0,0,6.288135593220339,0.25705012621708984
3033,231,239,8,0,0,8.769874476987448,0.3123659505643201
3034,62,231,169,0,0,7.67965367965368,0.2969320534537948
3035,6,230,224,0,0,7.278260869565218,0.2541104993354816
3036,239,239,0,0,0,10.782426778242678,0.28019408600260504
3037,231,231,0,0,0,10.454545454545455,0.26640316205533887
3038,0,240,240,0,0,5.995833333333334,0.2552126917712656
3039,0,243,243,0,0,6.078189300411522,0.29551406319083334
3040,143,235,92,0,0,8.038297872340426,0.26775777414075447
3041,8,227,219,0,0,7.299559471365638,0.2726989201200761
3042,3,230,227,0,0,7.147826086956521,0.26626162901082584
3043,0,227,227,0,0,6.290748898678414,0.251374215430201
3044,145,240,95,0,0,8.070833333333333,0.2836645746164585
3045,124,238,114,0,0,7.991596638655462,0.261532461085698
3046,240,240,0,0,0,10.45,0.290376569037663
3047,128,230,102,0,0,8.069565217391304,0.2920827795709135
3048,0,239,239,0,0,6.117154811715481,0.23831792131078458
3049,49,236,187,0,0,7.6440677966101696,0.2727731698521467
3050,0,240,240,0,0,6.9125,0.2642782426778258
3051,235,236,1,0,0,9.334745762711865,0.29172376487558915
3052,248,248,0,0,0,10.762096774193548,0.27110813634583164
3053,0,243,243,0,0,5.97119341563786,0.3008196442539906
3054,67,245,178,0,0,7.7877551020408164,0.2908330545332856
3055,56,245,189,0,0,7.722448979591837,0.2669120107059184
3056,0,234,234,0,0,6.260683760683761,0.339477642052751
3057,3,235,232,0,0,7.1063829787234045,0.26641207492271224
3058,79,239,160,0,0,7.803347280334728,0.2762912696459329
3059,33,234,201,0,0,7.568376068376068,0.2549613000256758
3060,0,244,244,0,0,6.036885245901639,0.26612359171557737
3061,231,232,1,0,0,9.125,0.30898268398268397
3062,229,243,14,0,0,8.703703703703704,0.28374655647383423
3063,247,247,0,0,0,10.004048582995951,0.28860142852440696
3064,0,226,226,0,0,6.831858407079646,0.33604719764012164
3065,3,231,228,0,0,6.991341991341991,0.2607942781855815
3066,0,241,241,0,0,6.29045643153527,0.3152835408022156
3067,0,235,235,0,0,6.348936170212766,0.2794326241134754
3068,153,234,81,0,0,8.188034188034187,0.35075749238839515
3069,0,233,233,0,0,6.450643776824034,0.2917344975580896
3070,1,235,234,0,0,6.74468085106383,0.2678668848881595
3071,34,246,212,0,0,7.532520325203252,0.2989381118300989
3072,243,243,0,0,0,9.876543209876543,0.2822161003979158
3073,24,235,211,0,0,7.43404255319149,0.2894344426259312
3074,34,234,200,0,0,7.52991452991453,0.2845090055390459
3075,0,229,229,0,0,5.96943231441048,0.24028958860032235
3076,1,235,234,0,0,6.897872340425532,0.24593562465902985
3077,0,226,226,0,0,6.084070796460177,0.26401179941003244
3078,53,244,191,0,0,7.655737704918033,0.27605747824327037
3079,228,233,5,0,0,8.901287553648068,0.27038626609442745
3080,230,230,0,0,0,10.891304347826088,0.2545092082779564
3081,242,242,0,0,0,10.636363636363637,0.3153526970954357
3082,4,240,236,0,0,7.145833333333333,0.25061018131102064
3083,243,245,2,0,0,8.955102040816326,0.26436935429909847
3084,20,227,207,0,0,7.440528634361233,0.2829519316985685
3085,33,237,204,0,0,7.527426160337553,0.2672530930415525
3086,0,236,236,0,0,6.593220338983051,0.2848900108186075
3087,0,235,235,0,0,6.251063829787234,0.25721040189125005
3088,0,237,237,0,0,6.472573839662447,0.2842022455839254
3089,159,233,74,0,0,8.201716738197424,0.2737901435548338
3090,0,242,242,0,0,6.776859504132231,0.26535441171427954
3091,10,240,230,0,0,7.333333333333333,0.2566248256624851
3092,0,242,242,0,0,6.822314049586777,0.24630499639930062
3093,11,244,233,0,0,7.336065573770492,0.27342643189637444
3094,0,236,236,0,0,6.258474576271187,0.30311936530832756
3095,32,236,204,0,0,7.63135593220339,0.2592679408582781
3096,0,233,233,0,0,6.618025751072961,0.29743229243746916
3097,241,241,0,0,0,10.67219917012448,0.26293222683264805
3098,0,232,232,0,0,6.232758620689655,0.3005672488431128
3099,214,234,20,0,0,8.564102564102564,0.27269725982172094
3100,0,232,232,0,0,6.021551724137931,0.27226078519181723
3101,0,229,229,0,0,6.331877729257642,0.3016547920018351
3102,108,242,134,0,0,7.913223140495868,0.2870443400432093
3103,4,233,229,0,0,7.1373390557939915,0.23967737161462443
3104,0,228,228,0,0,6.5394736842105265,0.2935891490841629
3105,111,236,125,0,0,7.9491525423728815,0.2782545979084039
3106,0,240,240,0,0,6.708333333333333,0.2827754532775479
3107,0,228,228,0,0,6.350877192982456,0.29925032846432914
3108,6,230,224,0,0,7.234782608695652,0.2677805202202409
3109,0,229,229,0,0,6.248908296943231,0.3018080134834874
3110,3,240,237,0,0,7.233333333333333,0.23821478382147482
3111,76,240,164,0,0,7.758333333333334,0.24260808926080993
3112,0,231,231,0,0,6.796536796536796,0.28450969320534647
3113,0,239,239,0,0,6.451882845188284,0.2907422383179223
3114,55,236,181,0,0,7.720338983050848,0.27890371438875167
3115,26,230,204,0,0,7.591304347826087,0.2514524397190013
3116,242,242,0,0,0,9.190082644628099,0.26247385206268037
3117,0,231,231,0,0,6.445887445887446,0.26553736118953764
3118,210,241,31,0,0,8.452282157676349,0.3154218533886554
3119,1,239,238,0,0,7.00418410041841,0.28149502478815724
3120,0,238,238,0,0,6.508403361344538,0.27630039357514946
3121,235,237,2,0,0,8.848101265822784,0.2988629049560139
3122,0,237,237,0,0,6.6118143459915615,0.2808767789458632
3123,234,234,0,0,0,10.944444444444445,0.3187887458273707
3124,74,228,154,0,0,7.785087719298246,0.2311422830203281
3125,8,239,231,0,0,7.205020920502092,0.28972258359410735
3126,0,233,233,0,0,6.44206008583691,0.28218884120171644
3127,0,237,237,0,0,6.755274261603375,0.2618894371737073
3128,21,229,208,0,0,7.458515283842795,0.28445568068642996
3129,0,239,239,0,0,6.205020920502092,0.28972258359410735
3130,0,239,239,0,0,6.0,0.3025210084033613
3131,13,233,220,0,0,7.330472103004292,0.2998002071925416
3132,1,239,238,0,0,7.050209205020921,0.29158609050314954
3133,229,245,16,0,0,8.653061224489797,0.2602877216460285
3134,231,231,0,0,0,10.792207792207792,0.25228684359119696
3135,10,231,221,0,0,7.333333333333333,0.2927536231884084
3136,236,237,1,0,0,9.181434599156118,0.3016877637130812
3137,32,231,199,0,0,7.458874458874459,0.29286655373611925
3138,21,229,208,0,0,7.467248908296943,0.3114226614571364
3139,0,241,241,0,0,6.713692946058091,0.25518672199170095
3140,235,235,0,0,0,9.191489361702128,0.29223495180941295
3141,0,228,228,0,0,6.8464912280701755,0.3067277223896745
3142,229,229,0,0,0,9.31004366812227,0.2499425419443804
3143,0,236,236,0,0,5.97457627118644,0.2802019473494395
3144,0,229,229,0,0,6.275109170305677,0.2704742204857148
3145,0,242,242,0,0,6.363636363636363,0.3070539419087137
3146,221,232,11,0,0,8.685344827586206,0.2685288849081969
3147,27,234,207,0,0,7.431623931623932,0.30646344594842256
3148,0,233,233,0,0,6.197424892703863,0.2539588574811268
3149,70,245,175,0,0,7.755102040816326,0.27584476413516107
3150,25,236,211,0,0,7.478813559322034,0.2761449693472736
3151,236,237,1,0,0,9.109704641350211,0.33537152256311376
3152,0,240,240,0,0,6.045833333333333,0.31169804741980117
3153,0,228,228,0,0,6.030701754385965,0.26777571682510015
3154,0,233,233,0,0,6.055793991416309,0.2598046470327047
3155,0,241,241,0,0,6.925311203319502,0.2443983402489645
3156,247,247,0,0,0,10.809716599190283,0.24413284618675812
3157,241,242,1,0,0,9.045454545454545,0.2925311203319502
3158,14,240,226,0,0,7.358333333333333,0.2643654114365376
3159,0,228,228,0,0,6.793859649122807,0.2700942885848944
3160,0,237,237,0,0,6.772151898734177,0.26989916326968694
3161,12,231,219,0,0,7.41991341991342,0.27942781855825
3162,237,237,0,0,0,10.80168776371308,0.29525137667167006
3163,1,242,241,0,0,6.87603305785124,0.275024861973183
3164,243,244,1,0,0,8.954918032786885,0.24075760642245234
3165,0,235,235,0,0,6.6680851063829785,0.2654300781960357
3166,96,234,138,0,0,7.901709401709402,0.23493268772238796
3167,0,237,237,0,0,6.3544303797468356,0.28910105127654834
3168,98,240,142,0,0,7.9125,0.2977510460251061
3169,241,244,3,0,0,8.94672131147541,0.22348714835053166
3170,5,239,234,0,0,7.175732217573222,0.2631060792517844
3171,20,228,208,0,0,7.442982456140351,0.27426771775253056
3172,223,237,14,0,0,8.679324894514767,0.24418937280983824
3173,0,242,242,0,0,6.793388429752066,0.26418847090291475
3174,237,238,1,0,0,9.071428571428571,0.26913803496081756
3175,1,237,236,0,0,6.987341772151899,0.30068654795108374
3176,0,241,241,0,0,6.721991701244813,0.2598893499308436
3177,201,238,37,0,0,8.42436974789916,0.25374960110626943
3178,1,230,229,0,0,6.5,0.259825327510917
3179,7,240,233,0,0,7.195833333333334,0.2752963737796384
3180,232,242,10,0,0,8.710743801652892,0.3226226809780216
3181,0,229,229,0,0,5.965065502183406,0.2707040527081892
3182,10,239,229,0,0,7.343096234309623,0.2683449949017278
3183,243,243,0,0,0,9.386831275720164,0.2547019011665477
3184,11,237,226,0,0,7.30379746835443,0.2971465350783084
3185,2,242,240,0,0,7.12396694214876,0.299921127533349
3186,13,244,231,0,0,7.409836065573771,0.284018080010797
3187,37,230,193,0,0,7.565217391304348,0.2992215682551706
3188,231,231,0,0,0,9.995670995670995,0.29128552606813646
3189,0,233,233,0,0,6.240343347639485,0.22646884712150558
3190,0,241,241,0,0,6.813278008298755,0.35248962655601496
3191,1,233,232,0,0,6.660944206008583,0.30264910463223527
3192,23,227,204,0,0,7.453744493392071,0.3020545007991928
3193,0,230,230,0,0,6.408695652173913,0.31258781089804055
3194,239,239,0,0,0,10.694560669456067,0.28026440701804317
3195,1,243,242,0,0,7.004115226337449,0.28510696187464224
3196,222,244,22,0,0,8.540983606557377,0.28226404911286634
3197,231,231,0,0,0,10.424242424242424,0.3235836627141037
3198,0,229,229,0,0,6.663755458515284,0.2767946066038476
3199,2,229,227,0,0,7.0524017467248905,0.2691718378916704
3200,55,236,181,0,0,7.6440677966101696,0.2557518932564021
3201,1,232,231,0,0,6.771551724137931,0.3242088371398692
3202,67,234,167,0,0,7.739316239316239,0.2879754961300042
3203,4,229,225,0,0,7.14410480349345,0.2642304451084081
3204,226,236,10,0,0,8.826271186440678,0.3143707176343324
3205,32,238,206,0,0,7.53781512605042,0.2918129277027277
3206,236,236,0,0,0,9.097457627118644,0.3010998918139252
3207,0,230,230,0,0,6.717391304347826,0.29096259730396534
3208,24,228,204,0,0,7.4868421052631575,0.2949802921400443
3209,0,237,237,0,0,6.662447257383966,0.27540584996066914
3210,80,232,152,0,0,7.862068965517241,0.3272130168681928
3211,158,238,80,0,0,8.155462184873949,0.30906286565258895
3212,9,228,219,0,0,7.214912280701754,0.2928162918309008
3213,0,232,232,0,0,6.512931034482759,0.2942043588595348
3214,101,228,127,0,0,7.890350877192983,0.2654571450653059
3215,0,244,244,0,0,6.688524590163935,0.24003238210888386
3216,223,243,20,0,0,8.584362139917696,0.2852089922796964
3217,3,234,231,0,0,6.773504273504273,0.3047026888228608
3218,54,238,184,0,0,7.684873949579832,0.2926816296138692
3219,0,231,231,0,0,6.6147186147186146,0.28134763786937306
3220,20,228,208,0,0,7.456140350877193,0.27560089651440983
3221,0,236,236,0,0,6.288135593220339,0.2825820411107069
3222,15,233,218,0,0,7.407725321888412,0.2770090276749999
3223,143,242,99,0,0,8.119834710743802,0.23869208874866937
3224,0,238,238,0,0,6.0210084033613445,0.3497677552033473
3225,240,240,0,0,0,9.775,0.27552301255229517
3226,0,232,232,0,0,6.094827586206897,0.28534109568591975
3227,181,244,63,0,0,8.315573770491802,0.2991803278688586
3228,29,242,213,0,0,7.516528925619835,0.27565927094407144
3229,0,241,241,0,0,6.385892116182573,0.2879668049792523
3230,234,234,0,0,0,9.944444444444445,0.2587029089174995
3231,1,229,228,0,0,7.126637554585153,0.24266452156592078
3232,0,230,230,0,0,6.373913043478261,0.2875261059426604
3233,74,229,155,0,0,7.8034934497816595,0.24630353175515457
3234,0,229,229,0,0,6.296943231441048,0.32371868535968434
3235,6,242,236,0,0,7.198347107438017,0.2758478790164949
3236,238,243,5,0,0,8.802469135802468,0.28313437404346387
3237,21,230,209,0,0,7.456521739130435,0.2928612113157381
3238,9,241,232,0,0,7.070539419087137,0.2658367911479976
3239,0,236,236,0,0,6.296610169491525,0.2861161197259285
3240,1,231,230,0,0,7.138528138528138,0.2763786937699953
3241,74,235,161,0,0,7.787234042553192,0.2451354791780362
3242,245,245,0,0,0,10.922448979591836,0.3013382402141211
3243,0,237,237,0,0,6.261603375527426,0.3211041979546558
3244,0,234,234,0,0,6.017094017094017,0.23146619713142966
3245,239,239,0,0,0,10.0418410041841,0.3175697057065444
3246,52,243,191,0,0,7.679012345679013,0.24364860728497315
3247,0,232,232,0,0,6.004310344827586,0.26405060456784457
3248,138,243,105,0,0,8.05761316872428,0.28592320511512104
3249,232,232,0,0,0,10.051724137931034,0.30034333482608694
3250,66,240,174,0,0,7.75,0.2719665271966527
3251,129,234,105,0,0,8.017094017094017,0.274384652067052
3252,17,231,214,0,0,7.359307359307359,0.2572934312064757
3253,8,243,235,0,0,7.1687242798353905,0.2565384484576438
3254,1,228,227,0,0,7.162280701754386,0.2687031455290211
3255,0,230,230,0,0,6.28695652173913,0.29284222517562103
3256,0,229,229,0,0,6.11353711790393,0.3203861181337631
3257,0,238,238,0,0,6.176470588235294,0.20501365103003
3258,227,229,2,0,0,8.882096069868995,0.2798973416072904
3259,1,235,234,0,0,6.804255319148936,0.27775959265321026
3260,241,241,0,0,0,9.477178423236515,0.25885200553251103
3261,237,237,0,0,0,10.80168776371308,0.21050561395980566
3262,0,241,241,0,0,6.850622406639004,0.2692600276625171
3263,72,235,163,0,0,7.740425531914894,0.25284597199490827
3264,3,239,236,0,0,7.200836820083682,0.278822826201607
3265,0,234,234,0,0,6.363247863247863,0.318128461905286
3266,87,232,145,0,0,7.900862068965517,0.2715144051350932
3267,74,232,158,0,0,7.793103448275862,0.2773548290789651
3268,117,244,127,0,0,7.987704918032787,0.2837988261485538
3269,0,238,238,0,0,6.798319327731092,0.22919547565861995
3270,0,235,235,0,0,6.136170212765958,0.22924168030551348
3271,0,229,229,0,0,6.427947598253275,0.2809698919788564
3272,234,234,0,0,0,10.67094017094017,0.2732291552034096
3273,1,231,230,0,0,7.038961038961039,0.2810841332580426
3274,110,243,133,0,0,8.016460905349794,0.30551304288677755
3275,238,238,0,0,0,9.542016806722689,0.26615962840832585
3276,54,239,185,0,0,7.677824267782427,0.27811961604725605
3277,47,230,183,0,0,7.7043478260869565,0.25281944180747956
3278,230,232,2,0,0,8.883620689655173,0.25046648753544765
3279,70,229,159,0,0,7.751091703056769,0.2667202941852418
3280,240,240,0,0,0,10.516666666666667,0.26750348675035274
3281,0,241,241,0,0,6.236514522821577,0.2729944674965433
3282,0,244,244,0,0,6.594262295081967,0.29972002968359956
3283,129,236,107,0,0,7.991525423728813,0.22971510998917863
3284,2,237,235,0,0,6.894514767932489,0.3320460559250516
3285,239,239,0,0,0,9.326359832635983,0.2543862733377826
3286,0,241,241,0,0,6.605809128630705,0.256466113416324
3287,36,234,198,0,0,7.572649572649572,0.25435603976376414
3288,43,238,195,0,0,7.554621848739496,0.27337517285395196
3289,0,242,242,0,0,6.921487603305785,0.25522101436850275
3290,0,228,228,0,0,6.258771929824562,0.2807597186799609
3291,0,227,227,0,0,6.41409691629956,0.287941990565669
3292,10,243,233,0,0,7.296296296296297,0.25068870523415726
3293,232,232,0,0,0,10.431034482758621,0.24630541871921074
3294,1,231,230,0,0,7.017316017316017,0.31274233013363817
3295,231,231,0,0,0,9.896103896103897,0.21524562394128147
3296,3,232,229,0,0,6.8405172413793105,0.27315644125988925
3297,127,231,104,0,0,8.030303030303031,0.2903820816864264
3298,12,232,220,0,0,7.318965517241379,0.2614569338707259
3299,0,237,237,0,0,6.143459915611814,0.29289136808982497
3300,0,235,235,0,0,6.336170212765958,0.2924895435533736
3301,0,237,237,0,0,6.417721518987341,0.29510834584853307
3302,0,235,235,0,0,5.987234042553191,0.26906710310965387
3303,2,230,228,0,0,6.973913043478261,0.29625973039680886
3304,233,234,1,0,0,9.692307692307692,0.31693628260151263
3305,80,241,161,0,0,7.858921161825726,0.2550138312586417
3306,0,229,229,0,0,6.441048034934497,0.26514977399831385
3307,247,247,0,0,0,10.396761133603238,0.28096507685723937
3308,217,240,23,0,0,8.5125,0.2676255230125584
3309,0,226,226,0,0,6.579646017699115,0.27140609636184915
3310,45,236,191,0,0,7.593220338983051,0.27637937252073513
3311,0,234,234,0,0,6.076923076923077,0.3116540112248273
3312,0,228,228,0,0,6.337719298245614,0.27751371821624576
3313,0,244,244,0,0,6.491803278688525,0.3003440599068985
3314,247,247,0,0,0,11.004048582995951,0.29673150982521995
3315,122,241,119,0,0,7.95850622406639,0.3232710926694305
3316,40,238,198,0,0,7.579831932773109,0.29528773534730135
3317,245,245,0,0,0,10.408163265306122,0.2589494814319103
3318,237,238,1,0,0,8.819327731092438,0.2667978583838565
3319,243,243,0,0,0,9.921810699588477,0.28724960038091596
3320,89,236,147,0,0,7.889830508474576,0.29419401370356896
3321,79,228,149,0,0,7.842105263157895,0.23046603292372278
3322,23,232,209,0,0,7.525862068965517,0.2677265263472144
3323,40,229,189,0,0,7.598253275109171,0.30280395311422725
3324,0,244,244,0,0,6.823770491803279,0.23630506645078692
3325,4,238,234,0,0,7.008403361344538,0.25309364252029715
3326,229,229,0,0,0,9.637554585152838,0.24086416915651443
3327,233,233,0,0,0,10.07725321888412,0.2353855261210591
3328,234,235,1,0,0,9.391489361702128,0.281978541553012
3329,0,232,232,0,0,6.379310344827586,0.2797432452604853
3330,1,236,235,0,0,7.093220338983051,0.2380815001803096
3331,18,243,225,0,0,7.395061728395062,0.28956228956229263
3332,0,239,239,0,0,6.698744769874477,0.27020850181076234
3333,42,229,187,0,0,7.602620087336245,0.266835210296481
3334,241,241,0,0,0,10.684647302904564,0.2751383125864474
3335,192,241,49,0,0,8.323651452282158,0.2531466113416324
3336,0,240,240,0,0,6.5875,0.2935669456066961
3337,1,231,230,0,0,6.9004329004329,0.29873894221719915
3338,238,238,0,0,0,9.399159663865547,0.3336701769315326
3339,246,246,0,0,0,10.032520325203253,0.24383607101377233
3340,0,242,242,0,0,6.3884297520661155,0.2717327937999354
3341,229,229,0,0,0,9.79475982532751,0.3129548762736592
3342,0,230,230,0,0,6.4,0.3283842794759857
3343,243,243,0,0,0,10.473251028806585,0.3329592218481045
3344,0,232,232,0,0,6.616379310344827,0.28942752649649445
3345,0,233,233,0,0,7.085836909871245,0.2598416457007543
3346,97,241,144,0,0,7.858921161825726,0.26334716459197505
3347,247,247,0,0,0,10.356275303643725,0.3197063954445273
3348,213,243,30,0,0,8.526748971193415,0.275107982178683
3349,231,231,0,0,0,9.774891774891774,0.2969320534537869
3350,234,234,0,0,0,10.414529914529915,0.28665492828582706
3351,59,237,178,0,0,7.755274261603375,0.28731316598726664
3352,234,234,0,0,0,10.726495726495726,0.31972414805032856
3353,59,235,176,0,0,7.736170212765957,0.26342971449354763
3354,56,245,189,0,0,7.673469387755102,0.2535965205754453
3355,2,226,224,0,0,6.946902654867257,0.2549459193706975
3356,236,236,0,0,0,10.5,0.2851063829787234
3357,191,237,46,0,0,8.31223628691983,0.27497675749124273
3358,0,241,241,0,0,6.074688796680498,0.30273167358229786
3359,239,239,0,0,0,10.414225941422593,0.28567912520656663
3360,1,242,241,0,0,7.012396694214876,0.2695552278728428
3361,0,238,238,0,0,6.718487394957983,0.2875048753678651
3362,3,233,230,0,0,7.051502145922747,0.29043954417640855
3363,0,230,230,0,0,6.495652173913044,0.25980634137079994
3364,3,231,228,0,0,7.038961038961039,0.28977978543195565
3365,1,243,242,0,0,7.098765432098766,0.2794612794612792
3366,237,241,4,0,0,8.883817427385893,0.2947786998616872
3367,0,231,231,0,0,6.090909090909091,0.24822134387352138
3368,34,245,211,0,0,7.551020408163265,0.26480428236868275
3369,242,242,0,0,0,10.62396694214876,0.31029457151675144
3370,3,242,239,0,0,7.099173553719008,0.25568396145536854
3371,244,244,0,0,0,10.610655737704919,0.27988598799163683
3372,0,237,237,0,0,6.1308016877637135,0.25824215118358307
3373,186,228,42,0,0,8.359649122807017,0.27536903933843365
3374,130,240,110,0,0,8.1125,0.32620292887029134
3375,100,240,140,0,0,7.895833333333333,0.2527022315202257
3376,243,243,0,0,0,9.794238683127572,0.28806584362139476
3377,0,242,242,0,0,6.0041322314049586,0.261393642193342
3378,0,233,233,0,0,6.343347639484978,0.3040180553500077
3379,0,234,234,0,0,6.256410256410256,0.2773192472763294
3380,41,243,202,0,0,7.576131687242798,0.2865353875454914
3381,0,229,229,0,0,6.401746724890829,0.26771623381598164
3382,1,226,225,0,0,6.995575221238938,0.2977581120943958
3383,17,230,213,0,0,7.5,0.2685589519650655
3384,0,238,238,0,0,6.546218487394958,0.2911037832854689
3385,107,231,124,0,0,7.995670995670996,0.2999811782420495
3386,146,233,87,0,0,8.055793991416309,0.2684253366878771
3387,10,237,227,0,0,7.362869198312236,0.29149681756418155
3388,0,230,230,0,0,6.482608695652174,0.2595215492690356
3389,240,240,0,0,0,9.466666666666667,0.2582984658298476
3390,245,245,0,0,0,10.06938775510204,0.3271328203412492
3391,0,228,228,0,0,6.807017543859649,0.253342607620372
3392,168,245,77,0,0,8.16326530612245,0.2683171629307447
3393,81,233,152,0,0,7.849785407725322,0.2919934882344211
3394,239,239,0,0,0,10.326359832635983,0.27959635737139604
3395,26,229,203,0,0,7.5196506550218345,0.2682525090017646
3396,3,244,241,0,0,7.004098360655738,0.3168555623018275
3397,11,241,230,0,0,7.410788381742739,0.24304979253111772
3398,234,237,3,0,0,9.0084388185654,0.254165772724017
3399,94,243,149,0,0,7.868312757201646,0.23878515797707583
3400,3,243,240,0,0,7.094650205761317,0.25959936060945804
3401,236,242,6,0,0,8.690082644628099,0.2728472960460828
3402,117,241,124,0,0,8.0,0.20833333333333334
3403,234,234,0,0,0,10.482905982905983,0.2765305748138409
3404,233,233,0,0,0,9.55793991416309,0.27356815154655184
3405,42,233,191,0,0,7.67381974248927,0.2983202604706203
3406,2,242,240,0,0,6.904958677685951,0.2772367202770846
3407,1,231,230,0,0,6.567099567099567,0.28134763786937306
3408,239,239,0,0,0,9.368200836820083,0.27562321999929346
3409,0,241,241,0,0,6.352697095435684,0.2875864453665296
3410,0,237,237,0,0,6.379746835443038,0.3043338339412157
3411,0,227,227,0,0,6.572687224669603,0.28119761412810185
3412,231,231,0,0,0,9.601731601731602,0.27547524938829315
3413,236,236,0,0,0,10.09322033898305,0.2806346916696713
3414,178,232,54,0,0,8.323275862068966,0.28032168980444977
3415,42,244,202,0,0,7.581967213114754,0.28543479727450327
3416,97,242,145,0,0,7.892561983471074,0.27056685298857813
3417,7,242,235,0,0,7.293388429752066,0.2911594252597612
3418,119,243,124,0,0,7.995884773662551,0.2520491106349728
3419,0,226,226,0,0,6.486725663716814,0.2864896755162206
3420,3,235,232,0,0,6.910638297872341,0.2697581378432425
3421,1,229,228,0,0,7.152838427947598,0.30548532904313425
3422,7,228,221,0,0,7.315789473684211,0.27869232552747425
3423,2,239,237,0,0,6.895397489539749,0.287331669069302
3424,126,232,106,0,0,8.025862068965518,0.2677265263472144
3425,0,236,236,0,0,6.203389830508475,0.2648395239812476
3426,234,234,0,0,0,10.094017094017094,0.2829683430541842
3427,0,230,230,0,0,6.6173913043478265,0.2459844313651039
3428,216,235,19,0,0,8.63404255319149,0.28430623749773076
3429,0,236,236,0,0,6.351694915254237,0.2715290299314802
3430,194,235,41,0,0,8.417021276595746,0.26979450809237754
3431,61,239,178,0,0,7.656903765690377,0.27674835624626565
3432,0,235,235,0,0,6.004255319148936,0.27775959265321026
3433,246,246,0,0,0,10.878048780487806,0.23812842210055368
3434,0,235,235,0,0,6.480851063829787,0.2934351700309151
3435,79,244,165,0,0,7.778688524590164,0.31295958982662214
3436,243,243,0,0,0,10.786008230452675,0.2680678842295064
3437,36,239,203,0,0,7.589958158995816,0.28494075454449663
3438,16,240,224,0,0,7.3625,0.2822698744769859
3439,6,242,236,0,0,7.2190082644628095,0.2630396762799658
3440,2,234,232,0,0,7.098290598290598,0.26926745167088584
3441,135,232,97,0,0,8.155172413793103,0.29616360650843054
3442,0,235,235,0,0,6.68936170212766,0.30052736861247636
3443,71,242,171,0,0,7.756198347107438,0.24321868248688477
3444,0,232,232,0,0,6.0344827586206895,0.3451261382295862
3445,175,239,64,0,0,8.213389121338912,0.2946098941668753
3446,235,235,0,0,0,9.221276595744682,0.2585197308601495
3447,75,230,155,0,0,7.821739130434783,0.28686159103853837
3448,33,228,195,0,0,7.5964912280701755,0.3034237576319652
3449,239,239,0,0,0,9.581589958158995,0.2611722513273041
3450,8,244,236,0,0,7.299180327868853,0.28460837887067275
3451,0,243,243,0,0,6.061728395061729,0.23171104989287114
3452,63,234,171,0,0,7.7094017094017095,0.23278676497560685
3453,14,242,228,0,0,7.479338842975206,0.2672062000617275
3454,36,240,204,0,0,7.583333333333333,0.27754532775453533
3455,0,236,236,0,0,6.88135593220339,0.2496934727731717
3456,0,232,232,0,0,6.5905172413793105,0.2948014629049109
3457,0,235,235,0,0,6.114893617021276,0.24742680487361213
3458,87,229,142,0,0,7.877729257641922,0.28322990883321963
3459,232,232,0,0,0,9.112068965517242,0.28175847141363947
3460,0,238,238,0,0,6.571428571428571,0.27968655816756866
3461,241,241,0,0,0,10.995850622406639,0.26248271092669406
3462,221,230,9,0,0,8.682608695652174,0.2700018986140122
3463,14,233,219,0,0,7.429184549356223,0.27190321148439045
3464,22,230,208,0,0,7.547826086956522,0.26626162901082584
3465,0,241,241,0,0,6.224066390041494,0.2829183955739988
3466,100,241,141,0,0,7.91701244813278,0.2764177040110629
3467,6,229,223,0,0,7.283842794759825,0.2567992032482962
3468,95,241,146,0,0,7.8962655601659755,0.31002766251729097
3469,109,236,127,0,0,8.008474576271187,0.289289578074285
3470,0,233,233,0,0,6.660944206008583,0.2854077253218904
3471,0,237,237,0,0,6.556962025316456,0.26475005363655496
3472,0,243,243,0,0,6.20164609053498,0.3104105023296954
3473,0,238,238,0,0,6.390756302521009,0.2981420416267783
3474,239,239,0,0,0,9.824267782426778,0.30512288597446585
3475,64,241,177,0,0,7.759336099585062,0.30850622406639255
3476,1,237,236,0,0,6.6455696202531644,0.2806264750053619
3477,0,228,228,0,0,6.675438596491228,0.2642398948914147
3478,237,237,0,0,0,10.565400843881857,0.30608596152470163
3479,241,241,0,0,0,10.962655601659751,0.26109958506223546
3480,82,236,154,0,0,7.796610169491525,0.29037143887486466
3481,246,246,0,0,0,10.215447154471544,0.2758420441347342
3482,1,235,234,0,0,6.829787234042553,0.26150209128932184
3483,0,233,233,0,0,6.3004291845493565,0.305904987420451
3484,235,235,0,0,0,10.459574468085107,0.2750681942171258
3485,126,243,117,0,0,8.041152263374485,0.27102676597625897
3486,4,240,236,0,0,7.125,0.252092050209205
3487,0,234,234,0,0,6.170940170940171,0.27966692344374516
3488,0,229,229,0,0,6.013100436681222,0.2761434153068254
3489,118,229,111,0,0,8.026200873362445,0.24492453842028403
3490,242,242,0,0,0,10.632231404958677,0.2666746682212512
3491,0,226,226,0,0,6.411504424778761,0.27880039331366585
3492,2,227,225,0,0,6.872246696035242,0.28006705391602477
3493,0,230,230,0,0,6.4,0.28471615720524335
3494,18,234,216,0,0,7.461538461538462,0.29250577748431644
3495,7,229,222,0,0,7.100436681222708,0.22232436987665974
3496,6,237,231,0,0,7.198312236286919,0.26982764785811075
3497,0,230,230,0,0,6.01304347826087,0.2662046705904666
3498,247,247,0,0,0,10.437246963562753,0.2958427964846434
3499,0,229,229,0,0,6.213973799126638,0.25664598176664394
3500,8,237,229,0,0,7.198312236286919,0.26135307158692433
3501,0,229,229,0,0,6.62882096069869,0.2782885160499494
3502,27,237,210,0,0,7.434599156118144,0.28066223271115
3503,0,227,227,0,0,6.572687224669603,0.28119761412810185
3504,10,238,228,0,0,7.256302521008403,0.2842428110484683
3505,99,235,136,0,0,7.987234042553191,0.29470812875067953
3506,2,233,231,0,0,7.085836909871245,0.26846233535592673
3507,9,227,218,0,0,7.211453744493392,0.2736735409925558
3508,244,244,0,0,0,10.87704918032787,0.23996491938203748
3509,0,234,234,0,0,6.495726495726496,0.27680569311470626
3510,239,239,0,0,0,10.673640167364017,0.27959635737139604
3511,0,241,241,0,0,7.004149377593361,0.2791493775933607
3512,239,241,2,0,0,8.987551867219917,0.27901106500691336
3513,148,235,87,0,0,8.157446808510638,0.26997635933806036
3514,5,231,226,0,0,7.16017316017316,0.26553736118953764
3515,111,229,118,0,0,7.995633187772926,0.2675247069639163
3516,20,239,219,0,0,7.368200836820083,0.25041313596568004
3517,4,233,229,0,0,7.064377682403434,0.28463075329288023
3518,0,232,232,0,0,6.780172413793103,0.27614196148678555
3519,0,238,238,0,0,6.718487394957983,0.2706272382370634
3520,1,235,234,0,0,6.723404255319149,0.24368066921258114
3521,117,229,112,0,0,8.065502183406114,0.24569064582854544
3522,50,229,179,0,0,7.698689956331878,0.2553052938021944
3523,4,227,223,0,0,7.1233480176211454,0.26790378542746834
3524,105,234,129,0,0,7.918803418803419,0.2637650856535003
3525,245,245,0,0,0,10.363265306122448,0.24864503178319924
3526,26,233,207,0,0,7.476394849785407,0.30224211928370537
3527,53,235,182,0,0,7.646808510638298,0.2892525913802484
3528,246,246,0,0,0,10.463414634146341,0.25783972125435106
3529,3,234,231,0,0,6.914529914529915,0.2845090055390459
3530,27,238,211,0,0,7.5588235294117645,0.28977413750310566
3531,114,240,126,0,0,7.9875,0.28017782426778093
3532,25,232,207,0,0,7.530172413793103,0.29345797880280283
3533,0,240,240,0,0,6.5875,0.2768305439330559
3534,0,237,237,0,0,6.257383966244726,0.2682185510977618
3535,21,230,209,0,0,7.543478260869565,0.2841275868615897
3536,7,232,225,0,0,7.306034482758621,0.2739028213166133
3537,232,236,4,0,0,8.813559322033898,0.26296429859357884
3538,1,229,228,0,0,6.812227074235808,0.2935340534742959
3539,1,232,231,0,0,6.724137931034483,0.2872070458277339
3540,247,247,0,0,0,10.408906882591094,0.2914650603995948
3541,0,241,241,0,0,6.053941908713693,0.2929114799446779
3542,239,241,2,0,0,8.921161825726141,0.256258644536653
3543,245,245,0,0,0,9.840816326530613,0.26554031448644994
3544,0,232,232,0,0,5.939655172413793,0.28205702343633543
3545,0,234,234,0,0,6.222222222222222,0.25083452551264057
3546,82,246,164,0,0,7.796747967479675,0.30954040152646484
3547,8,244,236,0,0,7.192622950819672,0.3043074951089502
3548,25,243,218,0,0,7.510288065843621,0.267455701799136
3549,0,235,235,0,0,6.787234042553192,0.27932351336607036
3550,5,234,229,0,0,7.200854700854701,0.30712372987050723
3551,3,235,232,0,0,7.14468085106383,0.26957628659755967
3552,15,240,225,0,0,7.320833333333334,0.2857566248256635
3553,216,245,29,0,0,8.50204081632653,0.27561057209769374
3554,0,236,236,0,0,6.567796610169491,0.28900108186080226
3555,0,227,227,0,0,6.008810572687224,0.3096565436045376
3556,0,238,238,0,0,6.579831932773109,0.29528773534730135
3557,0,235,235,0,0,5.991489361702127,0.22214948172395219
3558,39,245,206,0,0,7.616326530612245,0.2702241552358634
3559,0,229,229,0,0,6.336244541484716,0.2767946066038476
3560,0,237,237,0,0,6.194092827004219,0.258778516770366
3561,30,244,214,0,0,7.479508196721311,0.2670680698913816
3562,231,245,14,0,0,8.620408163265306,0.27745065239211175
3563,10,243,233,0,0,7.333333333333333,0.2644628099173554
3564,180,228,48,0,0,8.390350877192983,0.30069943581420455
3565,119,239,120,0,0,7.945606694560669,0.27013818079533186
3566,0,228,228,0,0,6.118421052631579,0.2898794342684872
3567,12,230,218,0,0,7.308695652173913,0.2667362825137611
3568,122,243,121,0,0,8.024691358024691,0.2555861646770752
3569,234,235,1,0,0,9.208510638297872,0.29394435351882087
3570,239,239,0,0,0,9.456066945606695,0.299532365247347
3571,241,241,0,0,0,9.755186721991702,0.26898340248962993
3572,236,236,0,0,0,9.220338983050848,0.23209520375044604
3573,0,242,242,0,0,6.293388429752066,0.2911594252597612
3574,0,243,243,0,0,6.0,0.32231404958677684
3575,205,238,33,0,0,8.415966386554622,0.28615750097507564
3576,15,232,217,0,0,7.370689655172414,0.28623675175399177
3577,51,243,192,0,0,7.68724279835391,0.2819440193177587
3578,224,237,13,0,0,8.645569620253164,0.2806264750053619
3579,8,226,218,0,0,7.31858407079646,0.2891642084562449
3580,15,229,214,0,0,7.366812227074236,0.2683674251130038
3581,0,231,231,0,0,6.541125541125541,0.30156220591003224
3582,0,230,230,0,0,6.7,0.28951965065501867
3583,0,229,229,0,0,6.039301310043668,0.2659924921474014
3584,0,231,231,0,0,6.12987012987013,0.2613212874082424
3585,125,239,114,0,0,8.02510460251046,0.26827467388628967
3586,225,234,9,0,0,8.705128205128204,0.26031693628260755
3587,0,243,243,0,0,6.189300411522634,0.2945957895452853
3588,1,239,238,0,0,6.841004184100418,0.2939418445202358
3589,0,237,237,0,0,6.012658227848101,0.21594078523921933
3590,1,228,227,0,0,7.030701754385965,0.3206391529484482
3591,242,242,0,0,0,10.97107438016529,0.25227186996330053
3592,239,239,0,0,0,10.748953974895397,0.3568791533349717
3593,22,241,219,0,0,7.45643153526971,0.2824688796680524
3594,244,245,1,0,0,9.220408163265306,0.2790899966543979
3595,228,236,8,0,0,8.652542372881356,0.2787594662820103
3596,232,232,0,0,0,9.887931034482758,0.2384684281235962
3597,236,236,0,0,0,9.614406779661017,0.24642985935810274
3598,37,240,203,0,0,7.620833333333334,0.28659344490934097
3599,0,231,231,0,0,6.861471861471862,0.28507434594390835
3600,237,242,5,0,0,8.942148760330578,0.2621995130482531
3601,236,236,0,0,0,10.961864406779661,0.2836458708979487
3602,0,239,239,0,0,6.552301255230126,0.2651102281916953
3603,0,237,237,0,0,6.772151898734177,0.26989916326968694
3604,233,233,0,0,0,10.369098712446352,0.26835133935178573
3605,64,233,169,0,0,7.759656652360515,0.3126757436732297
3606,29,245,216,0,0,7.522448979591837,0.2669120107059184
3607,233,233,0,0,0,10.48068669527897,0.26794435400326366
3608,230,231,1,0,0,9.376623376623376,0.2705815923207252
3609,0,231,231,0,0,6.411255411255412,0.2518727649162468
3610,235,235,0,0,0,10.617021276595745,0.29714493544281106
3611,0,234,234,0,0,6.0085470085470085,0.2660210557206276
3612,237,237,0,0,0,9.713080168776372,0.23936208252879146
3613,1,228,227,0,0,7.0,0.27312775330396477
3614,234,234,0,0,0,9.521367521367521,0.27636550383332165
3615,201,241,40,0,0,8.406639004149378,0.32562240663899805
3616,0,237,237,0,0,6.839662447257384,0.2792676821855143
3617,125,237,112,0,0,8.029535864978904,0.27454766502180866
3618,0,227,227,0,0,6.828193832599119,0.23141397996179103
3619,0,236,236,0,0,5.978813559322034,0.3186981608366353
3620,192,230,38,0,0,8.430434782608696,0.2549648756407825
3621,0,227,227,0,0,6.048458149779735,0.26755292191337826
3622,0,235,235,0,0,6.417021276595745,0.29543553373340314
3623,56,242,186,0,0,7.710743801652892,0.3060251706045776
3624,0,232,232,0,0,6.262931034482759,0.23792730258247852
3625,0,234,234,0,0,6.666666666666667,0.30042918454935624
3626,50,238,188,0,0,7.684873949579832,0.2842428110484683
3627,117,237,120,0,0,8.033755274261603,0.27004219409282393
3628,247,247,0,0,0,10.425101214574898,0.26164379052696735
3629,233,233,0,0,0,9.75107296137339,0.28259582655024634
3630,233,233,0,0,0,10.034334763948499,0.24881604262245988
3631,235,235,0,0,0,10.370212765957447,0.29398072376795586
3632,0,226,226,0,0,6.017699115044247,0.23968534906587996
3633,231,231,0,0,0,10.090909090909092,0.3351778656126439
3634,77,245,168,0,0,7.759183673469388,0.2983271997323516
3635,229,230,1,0,0,9.108695652173912,0.22830833491551097
3636,0,232,232,0,0,5.995689655172414,0.3333146738319139
3637,235,235,0,0,0,9.668085106382978,0.2739770867430443
3638,0,238,238,0,0,6.516806722689076,0.2676488316845717
3639,102,229,127,0,0,8.013100436681222,0.2761434153068254
3640,8,238,230,0,0,7.260504201680672,0.2862816012480904
3641,21,232,211,0,0,7.4094827586206895,0.26016942827287626
3642,0,231,231,0,0,5.991341991341991,0.23470732166384234
3643,50,241,191,0,0,7.643153526970955,0.32213001383126233
3644,246,246,0,0,0,9.5,0.25918367346938775
3645,246,246,0,0,0,9.479674796747968,0.2832586693213819
3646,0,244,244,0,0,6.565573770491803,0.27140255009107334
3647,6,228,222,0,0,7.206140350877193,0.32295772470824247
3648,0,243,243,0,0,6.399176954732511,0.2738836173179573
3649,219,235,16,0,0,8.6,0.2495726495726558
3650,0,241,241,0,0,6.08298755186722,0.2847510373443962
3651,0,227,227,0,0,6.13215859030837,0.25679310748119033
3652,46,231,185,0,0,7.645021645021645,0.28213815170337236
3653,3,234,231,0,0,7.085470085470085,0.2759253145519215
3654,19,239,220,0,0,7.476987447698745,0.2757287015224507
3655,90,243,153,0,0,7.872427983539095,0.32663333673434497
3656,7,243,236,0,0,7.251028806584362,0.3044927388361753
3657,12,239,227,0,0,7.422594142259414,0.2618403009739436
3658,215,239,24,0,0,8.589958158995817,0.28494075454449663
3659,232,232,0,0,0,10.349137931034482,0.2715144051350932
3660,0,232,232,0,0,6.3405172413793105,0.26882743693088496
3661,0,233,233,0,0,6.527896995708154,0.28477874796507074
3662,5,238,233,0,0,7.147058823529412,0.3200546041201277
3663,54,243,189,0,0,7.703703703703703,0.2837465564738267
3664,242,242,0,0,0,9.140495867768594,0.2706354377421963
3665,0,239,239,0,0,6.435146443514644,0.2888435709011611
3666,90,238,148,0,0,7.873949579831932,0.254086444704461
3667,0,226,226,0,0,6.6902654867256635,0.27697148475909167
3668,248,248,0,0,0,10.89516129032258,0.29665665404205016
3669,233,233,0,0,0,10.274678111587983,0.32939914163089584
3670,3,227,224,0,0,7.079295154185022,0.26802073993216236
3671,248,248,0,0,0,10.67741935483871,0.2598929084497912
3672,241,241,0,0,0,10.406639004149378,0.28395573997233137
3673,69,229,160,0,0,7.777292576419214,0.2528154447253528
3674,247,247,0,0,0,10.37246963562753,0.25094631513116855
3675,1,229,228,0,0,6.550218340611353,0.2836512679077634
3676,6,240,234,0,0,7.1875,0.236663179916318
3677,232,232,0,0,0,9.150862068965518,0.30181743543812345
3678,241,241,0,0,0,9.688796680497925,0.2735822959889295
3679,242,242,0,0,0,10.359504132231406,0.28100888172559874
3680,239,239,0,0,0,10.07112970711297,0.23441510495411252
3681,0,240,240,0,0,6.279166666666667,0.2773884239888434
3682,0,228,228,0,0,6.175438596491228,0.2862663266094764
3683,0,230,230,0,0,6.5,0.28602620087336245
3684,31,234,203,0,0,7.512820512820513,0.26807527236712025
3685,54,235,181,0,0,7.706382978723404,0.29376250227313805
3686,113,237,124,0,0,8.037974683544304,0.29092469427161816
3687,1,238,237,0,0,6.798319327731092,0.24607311278942162
3688,0,236,236,0,0,6.194915254237288,0.2682293544897201
3689,7,227,220,0,0,7.176211453744493,0.3050953179213259
3690,218,238,20,0,0,8.584033613445378,0.26927986384427394
3691,0,238,238,0,0,6.1722689075630255,0.2528986278055542
3692,230,230,0,0,0,10.560869565217391,0.29977216631858217
3693,20,236,216,0,0,7.504237288135593,0.2595564370717608
3694,236,236,0,0,0,9.444915254237289,0.2565272268301534
3695,10,234,224,0,0,7.256410256410256,0.29448662925057834
3696,17,243,226,0,0,7.539094650205762,0.26602727612828686
3697,7,230,223,0,0,7.291304347826087,0.23354850958800324
3698,44,243,199,0,0,7.567901234567901,0.2877257422711965
3699,128,235,107,0,0,8.038297872340426,0.31049281687579716
3700,3,242,239,0,0,7.144628099173554,0.31509550426940164
3701,0,226,226,0,0,6.252212389380531,0.2605506391347121
3702,10,244,234,0,0,7.274590163934426,0.2823146461580011
3703,72,244,172,0,0,7.807377049180328,0.27961613708425886
3704,6,235,229,0,0,7.246808510638298,0.3063466084742655
3705,35,234,199,0,0,7.538461538461538,0.2581710135358186
3706,0,233,233,0,0,6.669527896995708,0.23945537960633467
3707,0,238,238,0,0,6.336134453781512,0.2747225472467491
3708,239,239,0,0,0,9.661087866108787,0.29221897964206994
3709,23,227,204,0,0,7.524229074889868,0.2947643366730348
3710,0,230,230,0,0,6.104347826086957,0.25107271691665145
3711,235,235,0,0,0,10.502127659574468,0.27670485542826373
3712,0,241,241,0,0,6.427385892116183,0.27074688796680374
3713,0,233,233,0,0,6.5965665236051505,0.26757436732277556
3714,0,238,238,0,0,6.668067226890757,0.27332198702265775
3715,239,240,1,0,0,9.358333333333333,0.25599721059972513
3716,1,229,228,0,0,6.781659388646288,0.3029954799662926
3717,232,232,0,0,0,10.452586206896552,0.2747984773846854
3718,0,234,234,0,0,6.6752136752136755,0.29749458934008655
3719,244,244,0,0,0,10.319672131147541,0.2348377521419384
3720,234,234,0,0,0,10.594017094017094,0.25936319283959197
3721,2,244,242,0,0,7.110655737704918,0.3128077986912253
3722,22,244,222,0,0,7.413934426229508,0.3094346623490493
3723,127,239,112,0,0,8.03347280334728,0.25937906543370776
3724,0,229,229,0,0,6.528384279475983,0.294146939400905
3725,0,226,226,0,0,6.592920353982301,0.26910521140609894
3726,1,231,230,0,0,6.904761904761905,0.23436853002070204
3727,1,228,227,0,0,6.7894736842105265,0.307906329700903
3728,0,237,237,0,0,6.506329113924051,0.26796824715726053
3729,0,232,232,0,0,6.9094827586206895,0.23852440662785462
3730,11,228,217,0,0,7.390350877192983,0.27426771775253056
3731,0,231,231,0,0,6.8441558441558445,0.297346132128737
3732,0,228,228,0,0,6.087719298245614,0.29183089883298585
3733,7,239,232,0,0,7.322175732217573,0.2613128933581804
3734,28,232,204,0,0,7.564655172413793,0.2901739065532185
3735,0,232,232,0,0,6.129310344827586,0.25160471712195714
3736,39,240,201,0,0,7.604166666666667,0.2736227336122759
3737,0,236,236,0,0,6.898305084745763,0.27046520014424613
3738,0,226,226,0,0,6.393805309734513,0.3020058997050122
3739,0,233,233,0,0,6.463519313304721,0.2756030782891779
3740,69,243,174,0,0,7.806584362139918,0.2806176240519637
3741,217,241,24,0,0,8.473029045643154,0.28364453665283995
3742,0,242,242,0,0,6.566115702479339,0.30473920647439995
3743,209,239,30,0,0,8.481171548117155,0.3095179494391973
3744,25,242,217,0,0,7.446280991735537,0.2979321696786798
3745,232,232,0,0,0,10.331896551724139,0.30062322734737124
3746,2,234,232,0,0,6.978632478632479,0.3214298815157173
3747,0,227,227,0,0,6.154185022026431,0.25488285057112625
3748,236,236,0,0,0,10.61864406779661,0.31352326000721426
3749,96,233,137,0,0,7.8626609442060085,0.24829806126979684
3750,239,239,0,0,0,10.845188284518828,0.29946204423192413
3751,36,229,193,0,0,7.580786026200873,0.2796292040143989
3752,0,229,229,0,0,6.135371179039302,0.2491381291657059
3753,1,243,242,0,0,7.053497942386831,0.2574567221031843
3754,0,227,227,0,0,6.370044052863436,0.24299247592686127
3755,2,232,230,0,0,7.129310344827586,0.3035527690700091
3756,0,229,229,0,0,5.986899563318778,0.3375469240787552
3757,214,239,25,0,0,8.506276150627615,0.3014310326641159
3758,16,227,211,0,0,7.392070484581498,0.2748041012046329
3759,4,243,239,0,0,6.979423868312757,0.3177566914940647
3760,0,235,235,0,0,6.502127659574468,0.2852518639752645
3761,93,240,147,0,0,7.920833333333333,0.25730474198047065
3762,4,227,223,0,0,7.030837004405286,0.330903278624614
3763,2,232,230,0,0,7.004310344827586,0.26405060456784457
3764,0,235,235,0,0,6.1617021276595745,0.2557919621749378
3765,45,227,182,0,0,7.674008810572687,0.3003391680636215
3766,36,236,200,0,0,7.546610169491525,0.2829246303642263
3767,246,246,0,0,0,10.386178861788618,0.30331840053094106
3768,0,238,238,0,0,6.4033613445378155,0.2838705102294088
3769,248,248,0,0,0,10.024193548387096,0.25042444821731985
3770,245,245,0,0,0,10.49795918367347,0.28380729340916916
3771,0,241,241,0,0,6.626556016597511,0.2932918395574006
3772,109,237,128,0,0,7.924050632911392,0.2569191160695158
3773,0,231,231,0,0,6.216450216450217,0.24859777903256264
3774,6,231,225,0,0,7.233766233766234,0.2407679277244508
3775,0,243,243,0,0,6.061728395061729,0.26476890113254054
3776,150,243,93,0,0,8.090534979423868,0.2562323572424586
3777,0,227,227,0,0,6.290748898678414,0.2956220030408205
3778,243,243,0,0,0,10.621399176954732,0.3106145631398189
3779,189,236,47,0,0,8.385593220338983,0.27196177425171975
3780,0,239,239,0,0,6.138075313807532,0.25396434724517664
3781,198,228,30,0,0,8.412280701754385,0.2609938944276995
3782,0,235,235,0,0,6.5702127659574465,0.2803055100927469
3783,82,241,159,0,0,7.829875518672199,0.20010373443983553
3784,5,242,237,0,0,7.309917355371901,0.29774356160625637
3785,245,246,1,0,0,9.105691056910569,0.26633482661357505
3786,92,244,152,0,0,7.918032786885246,0.26485866558726046
3787,84,231,147,0,0,7.8441558441558445,0.297346132128737
3788,2,229,227,0,0,7.122270742358078,0.23059832988585122
3789,17,228,211,0,0,7.359649122807017,0.27536903933843365
3790,0,235,235,0,0,6.8936170212765955,0.3006001091107464
3791,1,238,237,0,0,6.7899159663865545,0.30167003510264623
3792,0,227,227,0,0,6.537444933920705,0.29394565514015253
3793,245,245,0,0,0,9.693877551020408,0.34442957510873384
3794,0,241,241,0,0,6.518672199170124,0.2756915629322293
3795,38,244,206,0,0,7.549180327868853,0.2815219591175863
3796,18,237,219,0,0,7.3544303797468356,0.27215189873417545
3797,4,237,233,0,0,7.109704641350211,0.28452406493599514
3798,20,230,210,0,0,7.439130434782609,0.2997721663185901
3799,0,243,243,0,0,6.407407407407407,0.3085399449035788
3800,0,241,241,0,0,6.1203319502074685,0.2812932226832648
3801,10,226,216,0,0,7.3053097345132745,0.25748279252703976
3802,5,243,238,0,0,7.082304526748971,0.29071863415297716
3803,4,242,238,0,0,7.18595041322314,0.28478104317410535
3804,22,238,216,0,0,7.390756302521009,0.2559479487997741
3805,142,228,86,0,0,8.096491228070175,0.2902078986011282
3806,230,230,0,0,0,9.347826086956522,0.28896905259161504
3807,73,244,171,0,0,7.836065573770492,0.3104634689334115
3808,1,235,234,0,0,6.770212765957447,0.27175850154573833
3809,241,241,0,0,0,9.439834024896266,0.27240663900414197
3810,0,243,243,0,0,6.6419753086419755,0.2803795531068272
3811,238,238,0,0,0,9.222689075630251,0.275094848065801
3812,0,227,227,0,0,6.022026431718062,0.2694241939885389
3813,0,230,230,0,0,6.452173913043478,0.28372887791912277
3814,0,243,243,0,0,6.004115226337449,0.29337142468455957
3815,0,234,234,0,0,6.452991452991453,0.2831884376948765
3816,3,229,226,0,0,6.986899563318778,0.26737148548226397
3817,10,239,229,0,0,7.2594142259414225,0.2937660419816481
3818,0,235,235,0,0,6.604255319148936,0.2657937806874014
3819,194,236,42,0,0,8.317796610169491,0.2772989542012278
3820,226,232,6,0,0,8.875,0.2483766233766234
3821,245,245,0,0,0,9.395918367346939,0.2729340916694575
3822,0,227,227,0,0,6.325991189427313,0.3268878406299932
3823,237,245,8,0,0,8.787755102040816,0.28263633322181764
3824,0,231,231,0,0,6.6017316017316015,0.27547524938829315
3825,237,241,4,0,0,8.921161825726141,0.28125864453665295
3826,97,229,132,0,0,7.908296943231441,0.2590975254730725
3827,4,231,227,0,0,7.2770562770562774,0.27942781855825
3828,234,234,0,0,0,10.94017094017094,0.27966692344375293
3829,0,231,231,0,0,6.125541125541125,0.29286655373611925
3830,11,238,227,0,0,7.298319327731092,0.319912775236679
3831,1,232,231,0,0,6.625,0.26136363636363635
3832,0,238,238,0,0,6.109243697478991,0.24961883487572348
3833,50,236,186,0,0,7.635593220338983,0.29217454020915884
3834,20,237,217,0,0,7.40084388185654,0.3005077594221587
3835,92,245,153,0,0,7.840816326530613,0.26554031448644994
3836,207,235,28,0,0,8.395744680851063,0.30852882342244414
3837,0,230,230,0,0,5.969565217391304,0.2916460983482045
3838,0,236,236,0,0,6.872881355932203,0.3241976199062381
3839,41,237,196,0,0,7.60337552742616,0.2996495744832982
3840,0,233,233,0,0,6.266094420600858,0.2737161462187346
3841,134,244,110,0,0,8.03688524590164,0.3155063077649601
3842,0,245,245,0,0,6.661224489795918,0.28230177316828436
3843,11,232,221,0,0,7.3405172413793105,0.28614345424690224
3844,237,237,0,0,0,9.565400843881857,0.29761138525351516
3845,0,236,236,0,0,5.978813559322034,0.2506130544536566
3846,124,230,106,0,0,8.004347826086956,0.28382380861970824
3847,234,234,0,0,0,9.282051282051283,0.26345328491251957
3848,230,246,16,0,0,8.609756097560975,0.30423096067695915
3849,5,236,231,0,0,7.080508474576271,0.2785971871619156
3850,241,241,0,0,0,10.697095435684647,0.30369986168740676
3851,240,244,4,0,0,8.680327868852459,0.275990015516424
3852,9,241,232,0,0,7.219917012448133,0.2889349930843688
3853,0,232,232,0,0,6.396551724137931,0.29228243021346223
3854,238,238,0,0,0,10.487394957983193,0.2762117505229873
3855,14,229,215,0,0,7.270742358078603,0.268482341224243
3856,92,233,141,0,0,7.927038626609442,0.2920674855705203
3857,0,233,233,0,0,6.111587982832618,0.3064599674411715
3858,1,228,227,0,0,6.728070175438597,0.2693407527629637
3859,74,235,161,0,0,7.804255319148936,0.31194762684124444
3860,68,246,178,0,0,7.7317073170731705,0.3195619711299143
3861,0,235,235,0,0,6.625531914893617,0.2865248226950367
3862,59,243,184,0,0,7.728395061728395,0.28129782675237525
3863,0,231,231,0,0,6.021645021645021,0.23865989083380712
3864,217,245,28,0,0,8.473469387755102,0.26671127467380146
3865,121,232,111,0,0,7.978448275862069,0.2895768025078346
3866,0,234,234,0,0,6.299145299145299,0.2706430431752283
3867,32,234,202,0,0,7.602564102564102,0.2576758005942531
3868,43,242,199,0,0,7.640495867768595,0.24781386097870325
3869,196,242,46,0,0,8.318181818181818,0.2842323651452282
3870,7,240,233,0,0,7.191666666666666,0.3145746164574581
3871,230,230,0,0,0,10.634782608695652,0.2590468957660924
3872,0,243,243,0,0,6.444444444444445,0.2892561983471074
3873,1,240,239,0,0,6.554166666666666,0.3066771269177137
3874,17,234,217,0,0,7.414529914529915,0.2694875463115781
3875,231,231,0,0,0,9.696969696969697,0.2555994729907821
3876,71,236,165,0,0,7.754237288135593,0.24572664983771825
3877,0,241,241,0,0,6.6887966804979255,0.24024896265560378
3878,1,233,232,0,0,6.412017167381975,0.28640668935918256
3879,247,247,0,0,0,11.024291497975709,0.23517988216318794
3880,62,232,170,0,0,7.7155172413793105,0.3256456187490668
3881,247,247,0,0,0,9.538461538461538,0.25766103814884983
3882,0,240,240,0,0,6.020833333333333,0.2547942817294307
3883,208,235,27,0,0,8.51063829787234,0.29368976177487577
3884,136,241,105,0,0,8.16597510373444,0.3223374827109258
3885,14,229,215,0,0,7.388646288209607,0.2649582471462485
3886,117,232,115,0,0,8.012931034482758,0.25524331989849586
3887,241,241,0,0,0,9.941908713692946,0.304944674965418
3888,27,244,217,0,0,7.495901639344262,0.30039465695203327
3889,9,241,232,0,0,7.190871369294606,0.25508298755186537
3890,56,232,176,0,0,7.689655172413793,0.2928795342588462
3891,121,245,124,0,0,7.942857142857143,0.25901639344262595
3892,0,240,240,0,0,6.229166666666667,0.286175034867506
3893,78,238,160,0,0,7.848739495798319,0.23018827784278384
3894,1,234,233,0,0,6.5085470085470085,0.2767506694545332
3895,4,239,235,0,0,7.108786610878661,0.2906367567947651
3896,237,238,1,0,0,9.214285714285714,0.2703435804701584
3897,220,242,22,0,0,8.541322314049587,0.29911525667844535
3898,172,241,69,0,0,8.207468879668049,0.24844398340248972
3899,128,235,107,0,0,8.042553191489361,0.2545917439534434
3900,0,245,245,0,0,6.722448979591837,0.29150217464034467
3901,1,233,232,0,0,7.0,0.28448275862068967
3902,87,230,143,0,0,7.843478260869565,0.2898044427567909
3903,0,234,234,0,0,6.277777777777778,0.2529804482594217
3904,0,227,227,0,0,6.343612334801762,0.2530895481657643
3905,0,236,236,0,0,6.3940677966101696,0.26532636134150844
3906,0,240,240,0,0,6.7875,0.26009414225941574
3907,61,239,178,0,0,7.682008368200837,0.31022115959354823
3908,1,236,235,0,0,6.601694915254237,0.291741795888927
3909,2,243,241,0,0,6.8765432098765435,0.3152739516375852
3910,8,230,222,0,0,7.239130434782608,0.2700778431744806
3911,47,233,186,0,0,7.716738197424893,0.3159686251294951
3912,239,239,0,0,0,9.845188284518828,0.2742519601983107
3913,0,241,241,0,0,5.983402489626556,0.2997233748271128
3914,37,232,195,0,0,7.625,0.295995670995671
3915,20,240,220,0,0,7.433333333333334,0.24658298465829492
3916,14,230,216,0,0,7.282608695652174,0.28222897284981685
3917,55,236,181,0,0,7.7076271186440675,0.26734583483591856
3918,231,231,0,0,0,9.813852813852813,0.2825898738942234
3919,247,247,0,0,0,10.445344129554655,0.2805371778414133
3920,2,229,227,0,0,6.93886462882096,0.25063203861181566
3921,0,231,231,0,0,6.0,0.26956521739130435
3922,0,231,231,0,0,6.5021645021645025,0.2684735554300736
3923,240,240,0,0,0,10.166666666666666,0.306834030683398
3924,46,244,198,0,0,7.639344262295082,0.27268434190110186
3925,96,229,133,0,0,7.899563318777292,0.26618401899946675
3926,77,228,151,0,0,7.7631578947368425,0.26964989566427333
3927,0,228,228,0,0,6.315789473684211,0.27869232552747425
3928,0,241,241,0,0,5.970954356846473,0.3283195020746916
3929,0,228,228,0,0,6.692982456140351,0.29299018471288296
3930,46,245,199,0,0,7.6204081632653065,0.2938440950150551
3931,0,228,228,0,0,6.333333333333333,0.30249632892804434
3932,0,242,242,0,0,6.793388429752066,0.25588971571619273
3933,224,229,5,0,0,8.790393013100436,0.271661686968512
3934,115,232,117,0,0,7.948275862068965,0.2570532915360515
3935,244,244,0,0,0,9.868852459016393,0.2625649328745814
3936,24,239,215,0,0,7.376569037656904,0.31138145634823183
3937,67,239,172,0,0,7.7238493723849375,0.33518512007313583
3938,179,238,59,0,0,8.256302521008404,0.31799808531007173
3939,119,239,120,0,0,7.895397489539749,0.26212158503568855
3940,0,231,231,0,0,6.181818181818182,0.29723320158102623
3941,0,240,240,0,0,6.333333333333333,0.29846582984658554
3942,0,236,236,0,0,6.8008474576271185,0.330382257482872
3943,0,231,231,0,0,5.991341991341991,0.21731601731601624
3944,241,244,3,0,0,9.049180327868852,0.28563718545503486
3945,206,238,32,0,0,8.457983193277311,0.2745984469737267
3946,0,239,239,0,0,6.673640167364017,0.2879997187159415
3947,35,230,195,0,0,7.582608695652174,0.28790582874501813
3948,0,244,244,0,0,6.709016393442623,0.24831343182891574
3949,0,242,242,0,0,6.338842975206612,0.2830492781454702
3950,162,241,79,0,0,8.199170124481327,0.3018326417703975
3951,150,245,95,0,0,8.118367346938776,0.26871863499497867
3952,0,244,244,0,0,6.073770491803279,0.2332186466977005
3953,52,240,188,0,0,7.704166666666667,0.25939679218967565
3954,23,230,207,0,0,7.51304347826087,0.2596544522498553
3955,0,237,237,0,0,6.443037974683544,0.27322462990774143
3956,237,242,5,0,0,8.909090909090908,0.33195020746887965
3957,10,226,216,0,0,7.314159292035399,0.26086529006883213
3958,1,236,235,0,0,6.741525423728813,0.26056617381896585
3959,108,234,126,0,0,7.961538461538462,0.29465170023109755
3960,231,231,0,0,0,10.004329004329005,0.29128552606813646
3961,242,242,0,0,0,9.508264462809917,0.28416378039162515
3962,243,243,0,0,0,9.304526748971194,0.2539876883311231
3963,0,226,226,0,0,6.075221238938053,0.24764995083579075
3964,223,239,16,0,0,8.635983263598327,0.29130480644140455
3965,135,243,108,0,0,8.053497942386832,0.30704349896268845
3966,14,244,230,0,0,7.385245901639344,0.295419280847331
3967,2,232,230,0,0,6.939655172413793,0.2907150320943441
3968,1,235,234,0,0,6.702127659574468,0.2869612656846724
3969,0,228,228,0,0,6.600877192982456,0.258501429785915
3970,0,241,241,0,0,6.622406639004149,0.3109958506224075
3971,1,244,243,0,0,6.733606557377049,0.2703062807798723
3972,90,238,148,0,0,7.815126050420168,0.32854660851682277
3973,80,229,149,0,0,7.895196506550218,0.2872136673561631
3974,0,233,233,0,0,6.141630901287554,0.25140594938582206
3975,0,239,239,0,0,6.2301255230125525,0.2619457824971008
3976,10,234,224,0,0,7.32051282051282,0.2530538131396525
3977,72,238,166,0,0,7.8277310924369745,0.23602099067475252
3978,239,239,0,0,0,10.301255230125523,0.3206286698779969
3979,5,241,236,0,0,7.16597510373444,0.26400414937759253
3980,235,245,10,0,0,8.706122448979592,0.29852793576446857
3981,106,228,122,0,0,7.9298245614035086,0.3034237576319652
3982,0,232,232,0,0,6.663793103448276,0.28474399164054365
3983,15,241,226,0,0,7.410788381742739,0.30138312586445104
3984,0,232,232,0,0,6.586206896551724,0.27825048514703715
3985,19,235,216,0,0,7.382978723404255,0.280050918348794
3986,234,234,0,0,0,10.679487179487179,0.2616375041267769
3987,7,238,231,0,0,7.277310924369748,0.2434492784455555
3988,3,237,234,0,0,7.071729957805907,0.29568046914109647
3989,26,231,205,0,0,7.454545454545454,0.29249011857707796
3990,40,237,197,0,0,7.565400843881856,0.28066223271115
3991,231,231,0,0,0,9.484848484848484,0.2682476943346441
3992,0,235,235,0,0,6.1063829787234045,0.29205310056373784
3993,238,238,0,0,0,9.571428571428571,0.27968655816756866
3994,37,228,191,0,0,7.605263157894737,0.2752144678877828
3995,0,231,231,0,0,6.034632034632034,0.28575192923018894
3996,233,238,5,0,0,8.731092436974789,0.24805871715774944
3997,3,239,236,0,0,7.171548117154812,0.21834675292711453
3998,237,237,0,0,0,10.69620253164557,0.2632482299935626
3999,3,236,233,0,0,7.008474576271187,0.22971510998917863
4000,240,240,0,0,0,10.220833333333333,0.23973152022315303
4001,59,233,174,0,0,7.6995708154506435,0.2628015391445889
4002,32,233,201,0,0,7.5965665236051505,0.27619505697794794
4003,0,239,239,0,0,6.497907949790795,0.3014661931718273
4004,0,234,234,0,0,6.162393162393163,0.2653607717985429
4005,4,242,238,0,0,7.190082644628099,0.2790713624361319
4006,46,228,182,0,0,7.714912280701754,0.2575740010820021
4007,126,241,115,0,0,8.049792531120332,0.28917704011065176
4008,0,242,242,0,0,6.615702479338843,0.2624909982510887
4009,237,237,0,0,0,10.350210970464135,0.27937495530286316
4010,106,233,127,0,0,7.944206008583691,0.2598046470327047
4011,2,235,233,0,0,7.097872340425532,0.2339698126932132
4012,126,239,113,0,0,8.01255230125523,0.2897577441018264
4013,0,241,241,0,0,6.2987551867219915,0.28537344398340186
4014,0,243,243,0,0,6.11522633744856,0.30898207665884625
4015,211,231,20,0,0,8.584415584415584,0.2874082439299894
4016,91,240,149,0,0,7.8875,0.30109832635983114
4017,52,236,184,0,0,7.673728813559322,0.2718175261449707
4018,0,238,238,0,0,6.445378151260504,0.29025280998475367
4019,0,241,241,0,0,6.232365145228216,0.2791147994467489
4020,2,230,228,0,0,6.952173913043478,0.2990127207138826
4021,53,235,182,0,0,7.680851063829787,0.2609565375522811
4022,234,234,0,0,0,10.542735042735043,0.28357360331608805
4023,234,234,0,0,0,9.495726495726496,0.2682220021275818
4024,27,229,202,0,0,7.4847161572052405,0.2947215199571011
4025,132,238,106,0,0,8.079831932773109,0.30161684927135196
4026,3,242,239,0,0,7.1652892561983474,0.28791879565172346
4027,237,246,9,0,0,8.731707317073171,0.24609258337481224
4028,241,241,0,0,0,10.535269709543568,0.29979253112032894
4029,6,246,240,0,0,7.056910569105691,0.29062551850008594
4030,0,232,232,0,0,6.543103448275862,0.30982236154649756
4031,0,240,240,0,0,6.841666666666667,0.2593444909344501
4032,237,237,0,0,0,9.316455696202532,0.27655009654581125
4033,24,237,213,0,0,7.552742616033755,0.26521490381176943
4034,8,232,224,0,0,7.237068965517241,0.2768883415435175
4035,2,236,234,0,0,7.114406779661017,0.28898305084745673
4036,233,233,0,0,0,10.283261802575108,0.32458931478466746
4037,1,232,231,0,0,6.900862068965517,0.25419838781907583
4038,11,242,231,0,0,7.309917355371901,0.27284729604609037
4039,0,238,238,0,0,6.369747899159663,0.2593341133921933
4040,15,236,221,0,0,7.432203389830509,0.24644789037144058
4041,176,228,52,0,0,8.289473684210526,0.2770693252956166
4042,244,245,1,0,0,9.204081632653061,0.25326196052191946
4043,0,232,232,0,0,6.818965517241379,0.25279892521271724
4044,0,239,239,0,0,6.150627615062762,0.29654372209134794
4045,80,230,150,0,0,7.817391304347826,0.2721853047275493
4046,0,228,228,0,0,6.407894736842105,0.2690122884303307
4047,246,246,0,0,0,10.536585365853659,0.27416625186659593
4048,1,236,235,0,0,6.796610169491525,0.25632888568337525
4049,0,241,241,0,0,6.278008298755187,0.28488934993084364
4050,7,233,226,0,0,7.296137339055794,0.26106260174633616
4051,234,239,5,0,0,8.849372384937238,0.29654372209134794
4052,230,230,0,0,0,9.382608695652173,0.28965255363584624
4053,0,235,235,0,0,5.94468085106383,0.24906346608474225
4054,100,240,140,0,0,7.875,0.2688284518828452
4055,0,231,231,0,0,7.017316017316017,0.23448146056842076
4056,248,248,0,0,0,10.794354838709678,0.3421542379521992
4057,242,242,0,0,0,9.888429752066116,0.2738074825966159
4058,235,235,0,0,0,10.25531914893617,0.2678668848881595
4059,35,243,208,0,0,7.617283950617284,0.2454851545760617
4060,0,226,226,0,0,6.3584070796460175,0.29319567354965936
4061,226,235,9,0,0,8.651063829787233,0.27943262411346764
4062,0,227,227,0,0,6.475770925110132,0.26821566410666314
4063,0,240,240,0,0,6.566666666666666,0.3051603905160355
4064,0,231,231,0,0,6.714285714285714,0.26583850931676906
4065,234,234,0,0,0,9.824786324786325,0.23955467517698864
4066,0,234,234,0,0,7.136752136752137,0.29881515718425594
4067,0,229,229,0,0,6.039301310043668,0.25722056232284
4068,0,242,242,0,0,6.776859504132231,0.2736531669010015
4069,0,239,239,0,0,6.7531380753138075,0.2959459934601466
4070,60,244,184,0,0,7.672131147540983,0.28712136544559497
4071,0,243,243,0,0,6.609053497942387,0.2886780260517652
4072,1,236,235,0,0,6.940677966101695,0.2517850703209486
4073,0,243,243,0,0,6.267489711934156,0.27939325919123803
4074,8,237,229,0,0,7.270042194092827,0.3589716083816033
4075,221,229,8,0,0,8.847161572052402,0.3142572588676877
4076,89,237,148,0,0,7.894514767932489,0.29814775084030587
4077,7,241,234,0,0,7.327800829875518,0.29626556016597383
4078,232,232,0,0,0,10.323275862068966,0.25434766383041596
4079,240,240,0,0,0,10.825,0.2705020920502153
4080,79,230,151,0,0,7.834782608695652,0.2345927472944751
4081,98,243,145,0,0,7.864197530864198,0.2913988368533812
4082,41,242,201,0,0,7.533057851239669,0.2831350090874815
4083,120,236,116,0,0,7.970338983050848,0.30124413992066656
4084,163,242,79,0,0,8.169421487603305,0.26578306642433625
4085,236,236,0,0,0,10.822033898305085,0.31712946267580266
4086,0,240,240,0,0,6.070833333333334,0.2752963737796384
4087,1,230,229,0,0,6.526086956521739,0.29407632428327174
4088,0,235,235,0,0,6.123404255319149,0.2368430623749805
4089,246,246,0,0,0,10.459349593495935,0.2820142691222771
4090,1,226,225,0,0,6.8584070796460175,0.3176401179941038
4091,0,240,240,0,0,7.0375,0.2538179916318007
4092,79,242,163,0,0,7.789256198347108,0.2832035938410921
4093,0,239,239,0,0,6.154811715481172,0.31626876692099215
4094,0,235,235,0,0,6.23404255319149,0.3338788870703741
4095,0,235,235,0,0,6.131914893617021,0.2859428987088531
4096,235,235,0,0,0,10.225531914893617,0.29507183124203745
4097,68,240,172,0,0,7.75,0.29707112970711297
4098,0,240,240,0,0,6.2375,0.2990062761506261
4099,94,245,151,0,0,7.8612244897959185,0.26754767480762714
4100,8,235,227,0,0,7.174468085106383,0.2557555919258028
4101,0,235,235,0,0,6.493617021276596,0.2766684851791209
4102,243,243,0,0,0,9.765432098765432,0.28772574227120407
4103,47,229,182,0,0,7.703056768558952,0.26231517658775455
4104,8,242,234,0,0,7.210743801652892,0.2998011042145361
4105,238,238,0,0,0,10.411764705882353,0.26855299081657347
4106,0,229,229,0,0,6.441048034934497,0.24760591434919102
4107,108,239,131,0,0,8.01673640167364,0.31064308568615423
4108,228,229,1,0,0,9.096069868995633,0.324063433693402
4109,3,229,226,0,0,7.034934497816594,0.288247912357316
4110,0,239,239,0,0,6.2175732217573225,0.26338736331352935
4111,0,235,235,0,0,6.004255319148936,0.28630660120021884
4112,120,236,116,0,0,8.0,0.28085106382978725
4113,130,242,112,0,0,8.041322314049587,0.26384554713486935
4114,97,238,141,0,0,7.894957983193278,0.24630358472503247
4115,233,233,0,0,0,9.40343347639485,0.27619505697795577
4116,118,242,124,0,0,7.987603305785124,0.2861527382462868
4117,0,237,237,0,0,6.755274261603375,0.27036401344489375
4118,236,236,0,0,0,10.847457627118644,0.2830147854309465
4119,162,236,74,0,0,8.139830508474576,0.2399386945546328
4120,0,239,239,0,0,6.2887029288702925,0.29865335255440834
4121,117,245,128,0,0,8.004081632653062,0.2909668785547019
4122,86,234,148,0,0,7.82051282051282,0.30241003631561814
4123,72,243,171,0,0,7.711934156378601,0.28031153283678606
4124,0,232,232,0,0,6.568965517241379,0.2982534706672627
4125,247,247,0,0,0,10.93927125506073,0.30117507652808795
4126,12,237,225,0,0,7.379746835443038,0.27891010512765635
4127,2,240,238,0,0,6.816666666666666,0.2926080892608054
4128,77,240,163,0,0,7.754166666666666,0.3033298465829811
4129,20,244,224,0,0,7.372950819672131,0.284203602509617
4130,61,234,173,0,0,7.705128205128205,0.28606800924397313
4131,2,228,226,0,0,7.074561403508772,0.2983808640544103
4132,0,236,236,0,0,6.622881355932203,0.28696357735304656
4133,241,241,0,0,0,10.464730290456432,0.25812586445366226
4134,3,235,232,0,0,6.897872340425532,0.2886706673940726
4135,7,241,234,0,0,7.161825726141079,0.236203319502071
4136,0,234,234,0,0,6.269230769230769,0.30059425552987545
4137,0,235,235,0,0,6.131914893617021,0.2603018730678275
4138,0,232,232,0,0,6.219827586206897,0.25016793551275956
4139,199,238,39,0,0,8.399159663865547,0.28303726553912756
4140,30,231,201,0,0,7.471861471861472,0.30246565029173444
4141,3,229,226,0,0,6.9126637554585155,0.281812610127936
4142,232,232,0,0,0,9.827586206896552,0.2558590834452914
4143,0,228,228,0,0,6.057017543859649,0.30069943581420455
4144,241,241,0,0,0,9.49792531120332,0.2593706777316735
4145,27,243,216,0,0,7.539094650205762,0.2742917389382042
4146,10,244,234,0,0,7.323770491803279,0.2609964244754783
4147,27,230,203,0,0,7.452173913043478,0.2749952534649743
4148,54,240,186,0,0,7.7375,0.2613493723849357
4149,0,232,232,0,0,5.956896551724138,0.21458426630840233
4150,231,231,0,0,0,9.303030303030303,0.2555994729907821
4151,0,240,240,0,0,6.4,0.2828451882845204
4152,0,226,226,0,0,6.451327433628318,0.2576204523107218
4153,217,234,17,0,0,8.534188034188034,0.292817578225305
4154,0,239,239,0,0,6.682008368200837,0.2513976301817835
4155,216,237,21,0,0,8.518987341772151,0.3015447328899442
4156,244,244,0,0,0,9.5,0.2839506172839506
4157,0,229,229,0,0,6.401746724890829,0.2940320232896658
4158,12,241,229,0,0,7.340248962655601,0.29208160442600123
4159,235,235,0,0,0,10.042553191489361,0.2716857610474605
4160,0,233,233,0,0,6.360515021459228,0.28326180257510775
4161,110,230,120,0,0,8.013043478260869,0.2400037972280212
4162,72,234,162,0,0,7.782051282051282,0.2741828986464174
4163,25,232,207,0,0,7.5344827586206895,0.2931780862815343
4164,248,248,0,0,0,10.65725806451613,0.28286208697923565
4165,0,236,236,0,0,6.3008474576271185,0.2708077893977656
4166,31,231,200,0,0,7.567099567099567,0.28134763786937306
4167,229,229,0,0,0,10.497816593886462,0.3300390714778252
4168,125,234,109,0,0,8.012820512820513,0.29597226807527477
4169,239,239,0,0,0,10.711297071129707,0.27344326852080253
4170,231,231,0,0,0,9.969696969696969,0.2903820816864343
4171,139,236,97,0,0,8.029661016949152,0.2501803101334325
4172,247,247,0,0,0,9.7165991902834,0.24456074520259893
4173,1,232,231,0,0,6.857758620689655,0.2870391103149743
4174,0,234,234,0,0,6.482905982905983,0.2679468838267086
4175,0,240,240,0,0,6.154166666666667,0.28994072524407355
4176,0,228,228,0,0,5.969298245614035,0.3118285802612275
4177,74,238,164,0,0,7.756302521008403,0.31166897138602107
4178,38,245,207,0,0,7.526530612244898,0.33228504516560475
4179,234,234,0,0,0,9.525641025641026,0.26758005942554697
4180,1,229,228,0,0,6.943231441048035,0.3169386347965947
4181,5,243,238,0,0,7.078189300411522,0.2707206747610813
4182,130,240,110,0,0,8.054166666666667,0.26065202231520324
4183,0,235,235,0,0,6.519148936170213,0.2934351700309151
4184,216,241,25,0,0,8.522821576763485,0.30051867219917766
4185,0,239,239,0,0,6.075313807531381,0.3136317288421609
4186,0,241,241,0,0,6.473029045643154,0.28364453665283235
4187,245,245,0,0,0,9.644897959183673,0.27092673134827283
4188,0,234,234,0,0,6.431623931623932,0.2721286819999247
4189,227,229,2,0,0,8.965065502183407,0.26193212288362383
4190,1,233,232,0,0,7.085836909871245,0.3029450939766164
4191,237,237,0,0,0,9.156118143459915,0.26789673174569206
4192,1,239,238,0,0,6.535564853556485,0.30860377623853197
4193,0,241,241,0,0,6.215767634854772,0.2449170124481346
4194,37,239,202,0,0,7.619246861924686,0.27038430434935773
4195,56,231,175,0,0,7.705627705627705,0.2868812347073206
4196,0,228,228,0,0,6.7894736842105265,0.31671690238812766
4197,0,232,232,0,0,6.75,0.24891774891774893
4198,0,238,238,0,0,5.983193277310924,0.2866361734567236
4199,88,241,153,0,0,7.804979253112033,0.307641770401104
4200,0,227,227,0,0,6.101321585903084,0.2772991306381831
4201,236,236,0,0,0,9.330508474576272,0.23923548503425604
4202,1,241,240,0,0,6.875518672199171,0.26777316735823053
4203,235,235,0,0,0,9.361702127659575,0.26604837243134655
4204,232,232,0,0,0,10.724137931034482,0.2958650544857425
4205,239,239,0,0,0,9.435146443514645,0.2888435709011611
4206,235,236,1,0,0,9.546610169491526,0.2914352686621064
4207,233,233,0,0,0,10.218884120171674,0.24929702530708114
4208,176,239,63,0,0,8.259414225941423,0.2601525966034968
4209,0,234,234,0,0,6.4914529914529915,0.28533436044165766
4210,224,231,7,0,0,8.831168831168831,0.28006775832862174
4211,0,235,235,0,0,6.093617021276596,0.2561556646663035
4212,14,229,215,0,0,7.4104803493449785,0.2518195050946129
4213,148,231,83,0,0,8.181818181818182,0.26245059288537403
4214,0,239,239,0,0,6.292887029288703,0.29200801659576314
4215,241,241,0,0,0,9.4149377593361,0.28544260027662555
4216,1,244,243,0,0,6.922131147540983,0.2614012008365415
4217,0,229,229,0,0,5.991266375545852,0.306940933118823
4218,154,240,86,0,0,8.091666666666667,0.2928172942817304
4219,9,232,223,0,0,7.245689655172414,0.2986826391998792
4220,0,230,230,0,0,6.730434782608696,0.2676286310992962
4221,0,227,227,0,0,6.158590308370044,0.31102101282601075
4222,242,246,4,0,0,8.890243902439025,0.28586361373818364
4223,1,239,238,0,0,6.7531380753138075,0.2959459934601466
4224,75,244,169,0,0,7.807377049180328,0.2055420630101848
4225,0,226,226,0,0,6.353982300884955,0.26525073746313055
4226,23,241,218,0,0,7.518672199170124,0.29235822959889596
4227,11,236,225,0,0,7.182203389830509,0.2687883159033555
4228,0,230,230,0,0,6.104347826086957,0.2074045946459091
4229,0,237,237,0,0,5.991561181434599,0.2287420439104654
4230,235,238,3,0,0,8.907563025210084,0.3289720951671765
4231,0,231,231,0,0,6.545454545454546,0.301185770750991
4232,244,244,0,0,0,10.336065573770492,0.2651959792214848
4233,238,239,1,0,0,9.188284518828452,0.25431595232234444
4234,91,236,145,0,0,7.851694915254237,0.28855030652722485
4235,0,232,232,0,0,6.629310344827586,0.25160471712195714
4236,234,238,4,0,0,8.777310924369749,0.3088501223274044
4237,105,239,134,0,0,7.96652719665272,0.292992510811859
4238,0,242,242,0,0,6.293388429752066,0.2579644045128732
4239,0,231,231,0,0,6.45021645021645,0.2920760399021278
4240,1,243,242,0,0,6.732510288065844,0.2463354079515686
4241,29,240,211,0,0,7.5375,0.2747384937238509
4242,0,227,227,0,0,6.211453744493392,0.2825230985146797
4243,17,243,226,0,0,7.440329218106996,0.3218379076964963
4244,237,237,0,0,0,10.080168776371307,0.2943931917328173
4245,145,239,94,0,0,8.087866108786612,0.23174290636756986
4246,242,245,3,0,0,9.03265306122449,0.26942121110738804
4247,10,239,229,0,0,7.2677824267782425,0.26412573397559935
4248,37,230,193,0,0,7.621739130434783,0.262407442566929
4249,84,239,155,0,0,7.828451882845188,0.2603635596498036
4250,0,236,236,0,0,5.991525423728813,0.289289578074285
4251,3,240,237,0,0,7.1375,0.30319037656903614
4252,0,228,228,0,0,6.7368421052631575,0.3092974727567844
4253,243,243,0,0,0,10.098765432098766,0.2959902050811214
4254,114,233,119,0,0,8.004291845493562,0.2715332248039102
4255,241,241,0,0,0,10.705394190871369,0.2836791147994518
4256,42,234,192,0,0,7.615384615384615,0.2806206668867607
4257,62,241,179,0,0,7.713692946058091,0.30518672199170094
4258,4,233,229,0,0,7.184549356223176,0.3063119727689809
4259,244,244,0,0,0,9.59016393442623,0.26755717466100276
4260,213,242,29,0,0,8.50413223140496,0.25931895339665395
4261,51,229,178,0,0,7.689956331877729,0.2762583314180646
4262,0,240,240,0,0,6.258333333333334,0.2593444909344501
4263,38,231,193,0,0,7.554112554112554,0.24814605684171154
4264,156,235,79,0,0,8.212765957446809,0.2707765048190618
4265,133,239,106,0,0,8.087866108786612,0.29056643577933455
4266,0,231,231,0,0,6.6017316017316015,0.29286655373611925
4267,0,230,230,0,0,6.017391304347826,0.2966394531991666
4268,0,233,233,0,0,6.257510729613734,0.2696092940654172
4269,90,231,141,0,0,7.83982683982684,0.28292866553736373
4270,122,235,113,0,0,8.012765957446808,0.2177850518276026
4271,25,244,219,0,0,7.512295081967213,0.2837988261485538
4272,230,238,8,0,0,8.722689075630251,0.3193986455341554
4273,91,237,146,0,0,7.894514767932489,0.24730029321318722
4274,0,239,239,0,0,6.682008368200837,0.24299426883724573
4275,244,244,0,0,0,9.032786885245901,0.28698643999190226
4276,0,243,243,0,0,6.674897119341564,0.27816889433051234
4277,195,242,47,0,0,8.388429752066116,0.2883303041733794
4278,63,244,181,0,0,7.717213114754099,0.26126627538284874
4279,44,237,193,0,0,7.632911392405063,0.30111564042051014
4280,241,241,0,0,0,9.423236514522822,0.2701244813278057
4281,0,228,228,0,0,6.37280701754386,0.2789048612721191
4282,7,244,237,0,0,7.245901639344262,0.2931930108614983
4283,123,237,114,0,0,8.025316455696203,0.29596653078738583
4284,2,234,232,0,0,7.115384615384615,0.3085176625949152
4285,198,228,30,0,0,8.43421052631579,0.2467539995362848
4286,150,228,78,0,0,8.171052631578947,0.29219800602828955
4287,83,242,159,0,0,7.859504132231405,0.2872329481156327
4288,0,234,234,0,0,6.773504273504273,0.3047026888228608
4289,3,233,230,0,0,7.218884120171674,0.29240047358295107
4290,94,241,147,0,0,7.921161825726141,0.24792531120331962
4291,78,233,155,0,0,7.776824034334764,0.2861846973508928
4292,236,236,0,0,0,10.004237288135593,0.26806707536963315
4293,80,230,150,0,0,7.886956521739131,0.29284222517562103
4294,22,243,221,0,0,7.4526748971193415,0.29010645172261434
4295,243,243,0,0,0,10.48559670781893,0.2673536713940818
4296,0,242,242,0,0,6.640495867768595,0.3059051472857572
4297,0,229,229,0,0,6.489082969432315,0.2772925764192175
4298,1,240,239,0,0,6.75,0.2719665271966527
4299,0,231,231,0,0,6.380952380952381,0.27163561076604703
4300,10,240,230,0,0,7.329166666666667,0.28868549511854597
4301,116,240,124,0,0,8.008333333333333,0.2928172942817304
4302,0,226,226,0,0,6.442477876106195,0.27445427728613947
4303,5,237,232,0,0,7.008438818565401,0.25416577272402474
4304,15,239,224,0,0,7.435146443514644,0.29724693224569887
4305,235,235,0,0,0,10.86808510638298,0.27739589016184457
4306,0,234,234,0,0,6.799145299145299,0.23845420197351155
4307,101,245,144,0,0,7.877551020408164,0.2964202074272329
4308,0,230,230,0,0,6.113043478260869,0.2579077273590272
4309,38,230,192,0,0,7.569565217391304,0.27243212454907945
4310,240,240,0,0,0,10.033333333333333,0.2582984658298476
4311,0,238,238,0,0,6.201680672268908,0.27982838705102503
4312,2,238,236,0,0,7.029411764705882,0.29870935716058844
4313,58,230,172,0,0,7.6695652173913045,0.25714828175431964
4314,0,237,237,0,0,6.29535864978903,0.259851247943932
4315,0,232,232,0,0,6.491379310344827,0.328929690998659
4316,238,238,0,0,0,10.857142857142858,0.2917420132610072
4317,248,248,0,0,0,10.57258064516129,0.27811153193157256
4318,0,240,240,0,0,6.25,0.24686192468619247
4319,0,235,235,0,0,6.2042553191489365,0.2828877977814185
4320,0,236,236,0,0,6.822033898305085,0.3086188243779303
4321,0,227,227,0,0,6.308370044052864,0.27616857042610604
4322,2,231,229,0,0,6.913419913419913,0.27942781855825
4323,231,238,7,0,0,8.920168067226891,0.3269333049675622
4324,25,237,212,0,0,7.5021097046413505,0.26800400486304865
4325,12,237,225,0,0,7.3164556962025316,0.2765500965458036
4326,1,233,232,0,0,6.76824034334764,0.24778007991712597
4327,145,231,86,0,0,8.177489177489177,0.30314323357801504
4328,171,233,62,0,0,8.32618025751073,0.2810788811602755
4329,1,238,237,0,0,6.823529411764706,0.2809630181186376
4330,7,228,221,0,0,7.197368421052632,0.27364943194991925
4331,2,244,242,0,0,6.897540983606557,0.2569486608648686
4332,86,230,144,0,0,7.886956521739131,0.28410860072147254
4333,245,245,0,0,0,10.391836734693877,0.26386751421879856
4334,0,228,228,0,0,6.219298245614035,0.26887703841100324
4335,235,235,0,0,0,10.153191489361703,0.2841243862520401
4336,0,230,230,0,0,6.760869565217392,0.2875450920827775
4337,0,238,238,0,0,6.079831932773109,0.2509839378789469
4338,27,241,214,0,0,7.4937759336099585,0.30100276625172834
4339,0,236,236,0,0,6.203389830508475,0.2648395239812476
4340,0,239,239,0,0,6.046025104602511,0.27938539432509685
4341,0,235,235,0,0,6.8,0.25470085470085624
4342,19,233,214,0,0,7.450643776824034,0.2658724285925724
4343,0,227,227,0,0,6.277533039647577,0.2633425597442567
4344,24,235,211,0,0,7.502127659574468,0.2852518639752645
4345,242,242,0,0,0,9.037190082644628,0.28491821268131895
4346,129,231,102,0,0,8.03896103896104,0.3158667419536948
4347,0,233,233,0,0,6.274678111587983,0.26905431404469676
4348,241,241,0,0,0,10.120331950207468,0.2646265560165981
4349,0,240,240,0,0,6.045833333333333,0.2614888423988807
4350,0,239,239,0,0,6.426778242677824,0.2708765514574018
4351,0,235,235,0,0,6.263829787234043,0.3061647572285904
4352,11,234,223,0,0,7.32051282051282,0.2873885770881503
4353,0,240,240,0,0,6.483333333333333,0.3177126917712656
4354,247,247,0,0,0,9.554655870445345,0.2642770152397873
4355,238,238,0,0,0,10.483193277310924,0.2676488316845794
4356,246,246,0,0,0,10.40650406504065,0.266733034677288
4357,187,229,42,0,0,8.37117903930131,0.2958323756990722
4358,1,227,226,0,0,6.748898678414097,0.27737710030798185
4359,206,229,23,0,0,8.572052401746724,0.2634260323297336
4360,25,243,218,0,0,7.493827160493828,0.3171104989286813
4361,0,230,230,0,0,6.086956521739131,0.28061515093981637
4362,0,232,232,0,0,6.047413793103448,0.27046947305568103
4363,69,230,161,0,0,7.804347826086956,0.2628631099297551
4364,117,238,121,0,0,8.0,0.27848101265822783
4365,0,235,235,0,0,6.1617021276595745,0.26433897072194634
4366,0,233,233,0,0,6.721030042918455,0.31408169305905176
4367,211,233,22,0,0,8.532188841201716,0.2672783779783866
4368,241,243,2,0,0,9.094650205761317,0.2678638234193829
4369,1,230,229,0,0,6.98695652173913,0.3011391684070605
4370,77,238,161,0,0,7.819327731092437,0.2667978583838565
4371,0,235,235,0,0,6.638297872340425,0.27459538097836284
4372,0,243,243,0,0,6.3539094650205765,0.2543958099513625
4373,38,242,204,0,0,7.570247933884297,0.2958746270704001
4374,23,243,220,0,0,7.448559670781893,0.2979627929122848
4375,247,247,0,0,0,10.117408906882591,0.27477699878212797
4376,2,238,236,0,0,6.966386554621849,0.25202992589440504
4377,0,230,230,0,0,6.034782608695652,0.30446174292766287
4378,0,232,232,0,0,6.163793103448276,0.25876996566651767
4379,0,235,235,0,0,7.004255319148936,0.24357155846517609
4380,0,238,238,0,0,6.315126050420168,0.30112044817927003
4381,0,232,232,0,0,5.982758620689655,0.2854157336915977
4382,202,239,37,0,0,8.426778242677825,0.29608663549101527
4383,15,242,227,0,0,7.363636363636363,0.24896265560165975
4384,0,227,227,0,0,6.352422907488987,0.26462905929593117
4385,0,230,230,0,0,6.6869565217391305,0.30332257452059763
4386,58,232,174,0,0,7.685344827586207,0.3118189281982402
4387,233,233,0,0,0,10.935622317596566,0.2501479946721984
4388,237,237,0,0,0,9.278481012658228,0.3119502252735494
4389,4,230,226,0,0,7.104347826086957,0.27727359027909687
4390,240,244,4,0,0,8.84016393442623,0.2665283680766406
4391,126,237,111,0,0,8.037974683544304,0.29092469427161816
4392,240,240,0,0,0,10.195833333333333,0.2752963737796384
4393,0,240,240,0,0,6.3375,0.25800209205021074
4394,0,227,227,0,0,6.13215859030837,0.2656426650033142
4395,0,243,243,0,0,6.139917695473251,0.31918511716491393
4396,13,238,225,0,0,7.361344537815126,0.2739424883877621
4397,2,231,229,0,0,6.9523809523809526,0.254244306418221
4398,9,241,232,0,0,7.331950207468879,0.28934993084370336
4399,0,227,227,0,0,6.722466960352423,0.28989123231062836
4400,0,227,227,0,0,6.361233480176211,0.27601263108650864
4401,39,244,205,0,0,7.60655737704918,0.28077986912230624
4402,124,244,120,0,0,8.01639344262295,0.2960264453889258
4403,1,238,237,0,0,7.088235294117647,0.2917597418714335
4404,16,230,214,0,0,7.430434782608696,0.2898993734573764
4405,13,243,230,0,0,7.296296296296297,0.3085399449035788
4406,211,243,32,0,0,8.497942386831276,0.2675577322041902
4407,0,241,241,0,0,6.1078838174273855,0.2716459197786965
4408,58,231,173,0,0,7.7229437229437226,0.27942781855825
4409,241,241,0,0,0,9.452282157676349,0.2820885200553221
4410,2,232,230,0,0,6.952586206896552,0.322417525003733
